abad	NN
abadi	NN
abah	NN
abai	NN
abalabal	NN
abang	NN
abdas	NN
abdikasi	NN
abduktor	NN
abece	DT
aberasi	NNS
abian	IN
abiotik	JJ
abjad	JJ
ablasi	NN
abnormalitas	NN
aboi	VB
abolisi	NN
abonemen	NN
aborsi	NN
abortus	NN
abras	JJ
abrasi	NN
abreaksi	NNS
abreviasi	MD
absah	JJ
absen	NN
absensi	NN
absente	NN
abses	NN
absis	NN
absolut	NN
absolutisme	NN
absorben	NN
absorpsi	NN
abstrak	NN
abstraksi	NN
absurdisme	NN
abuabu	NN
abuh	NN
abur	NN
abus	NN
acak	NN
acan	RB
acang	NN
acap	RB
kali	NN
acar	NNS
acara	NN
acat	DT
aciaci	NN
acik	JJ
acu	IN
acuh	NN
acum	RB
ada	RB
adab	NN
adagio	RB
adagium	NN
adakala	RB
adakan	VB
adalah	VBZ
adaptasi	NN
adaptif	JJ
adapun	IN
adar	NN
adas	NN
adat	NNS
adati	PRP
adegan	NN
adekuat	NN
adem	NN
adempauze	NN
adendum	NN
adhesi	NN
adib	NN
adiboga	IN
adibusana	NN
adidaya	NN
adik	NN
adikarya	NN
adikodrati	JJ
adiksi	NN
adiktif	JJ
adikuasa	NN
adil	NN
adiluhung	NN
adipati	NN
adiposa	NN
adipositas	NN
adisi	NNS
aditif	NNS
adiwarna	NN
adjektif	JJ
adjektiva	JJ
adjuvan	NN
administrasi	NN
administratif	JJ
adopsi	NN
adoptif	JJ
adrenergik	NN
adres	NN
adsorben	NN
adsorpsi	NN
adstringen	VBG
domba	NN
untung	NN
aduhai	JJ
aduk	VBG
aduktor	NN
adun	NN
adveksi	NN
adverbia	NNS
advokasi	NN
advokat	NN
aerasi	NN
aerob	NN
aerobatik	NNS
aerobik	NNS
aerobika	NNS
aerodinamik	JJ
aerodinamika	NNS
aerolit	NN
aeronautika	NNS
aeroskop	NN
aerostatika	JJ
afal	NN
afdeling	NN
afdruk	NN
afeksi	NN
afektif	JJ
afidavit	NN
afiks	NN
afiksasi	NN
afiliasi	NNS
afinitas	NN
afirmasi	NN
afirmatif	JJ
aforisme	NNS
afotik	IN
afrikat	NN
afrodisiak	NN
afsun	NN
agak	RB
agam	NN
agama	NN
agamais	JJ
agamawi	NN
agar	RB
agas	NN
agen	NN
agio	NN
agiria	NN
agitasi	NN
aglomerat	VBN
aglutinasi	NN
aglutinat	VBN
aglutinatif	JJ
agnostik	JJ
agnostisisme	NN
agonia	NN
agonis	NN
agradasi	NN
agraria	JJ
agraris	JJ
agregasi	NN
agregat	NN
agresi	NN
agresif	JJ
agresivitas	NN
agresor	NN
agrobisnis	NN
agroekonomi	NNS
agroekosistem	NN
agroindustri	NN
agrokimia	NNS
agronom	NN
agronomi	NN
agrowisata	NN
agul	NN
agung	JJ
agus	CC
agustus	NN
agut	NN
ahli	NN
ahmak	NN
aho	NN
aib	NN
ajaib	NN
ajak	NN
ajal	IN
ajang	NN
ajar	NN
ajarajar	VBG
ajek	VBG
aju	DT
ajudan	NN
ajun	NN
ajung	VB
akad	NNS
akademi	NN
akademik	JJ
akademikus	JJ
akademis	JJ
akademisi	NN
akal	NN
akan	MD
akapela	PRP
akar	MD
akas	NNS
akasia	NN
akene	RB
akhir	NN
akhirat	NN
akhirulkalam	JJ
akhlak	NN
aki	WP
akibat	NN
akil	NN
aklamasi	NN
akli	RB
aklimasi	DT
aklimatisasi	NN
akolade	NN
akomodasi	NN
akomodatif	VBG
akor	NN
akordeon	NN
akrab	JJ
akreditasi	NN
akrilat	NN
akrilik	NN
akrobat	NN
akrobatik	NNS
akrofobia	NN
akromegali	NN
akromion	NN
akronim	NN
aksara	NNS
aksarawati	DT
akselerasi	NN
akselerator	NN
akselerometer	NN
aksen	NN
aksentuasi	NN
akseptabel	JJ
akseptabilitas	NN
akseptasi	NN
akseptor	NN
akses	NN
aksesibilitas	NN
aksesori	NN
aksi	NN
aksidental	NN
aksila	NN
aksioma	NN
aksiomatis	JJ
aksis	NN
akson	NNS
aksostil	NN
akta	NN
aktif	JJ
aktinida	NN
aktinik	NN
aktinium	NN
aktinolit	NN
aktinometer	NN
aktiva	JJ
aktivis	NN
aktivisme	NN
aktivitas	NN
aktor	NN
aktris	NN
aktual	JJ
aktualisasi	NN
aktuaria	JJ
aktuaris	JJ
aku	NN
akua	NN
akuades	JJ
akuaduk	VBN
akuakultur	NN
akuarel	NN
akuarium	NN
akuarius	NN
akuatik	JJ
akuifer	NNS
akuisisi	NN
akulturasi	NN
akumulasi	NN
akumulatif	JJ
akumulator	NN
akun	NN
akuntabel	JJ
akuntabilitas	NN
akuntan	NN
akuntansi	NN
akupunktur	NN
akur	VBD
akurasi	NN
akurat	RB
akusatif	JJ
akustik	JJ
akustika	NNS
akut	NN
alam	NN
alamak	NN
alamat	NN
alami	JJ
alamiah	JJ
alang	NN
alangalang	NN
alangkah	WRB
alap	NN
alapalap	JJ
alat	NN
albit	NN
aldehida	NN
alegori	NN
alegoris	JJ
aleksia	NN
alel	NNS
alergen	NNS
alergi	NN
alfabet	NN
alfabetis	JJ
alfanumerik	NN
algojo	NN
algologi	NN
algoritme	NN
alhamdulillah	NN
alhasil	IN
ali	CC
aliali	NN
aliansi	NN
aliase	NNS
alienasi	NN
alifatik	JJ
alih	IN
fungsi	NN
alihragam	VBG
alikuot	NN
alim	NN
alimenter	NN
alinea	NN
aling	WDT
alir	VBZ
alis	NNS
alisiklik	VBZ
aljabar	NN
alkana	NN
alkausar	NN
alkil	NN
alkisah	JJ
alkitab	JJ
alkohol	NN
alkoholisme	NN
alku	JJ
alkuna	NN
almamater	NN
almanak	NN
almarhum	RB
almarhumah	VBN
alofon	NN
aloi	VBN
alokasi	NN
alomerisme	NN
alomorf	NN
alonim	NN
alotropi	NNS
alpaka	NN
alperes	NN
alquran	NN
alternatif	NN
altokumulus	NN
altruisme	NN
alun	DT
alunalun	NN
alung	NN
alur	NN
aluvial	JJ
aluvium	NN
ama	CC
amal	NN
amalgamasi	DT
aman	NN
amanah	NN
amanat	NN
amandel	NNS
amandemen	NN
amar	NN
amat	RB
amatir	NN
amatirisme	NN
ambak	VBG
ambal	NN
ambang	NN
ambasador	NN
ambek	JJ
ambigu	JJ
ambiguitas	NN
ambil	VB
ambing	NN
ambisi	NN
ambisius	JJ
ambivalen	NN
amblas	VBN
ambrol	NN
ambruk	NN
ambulans	NN
ambulatori	NNS
ambur	NN
amburadul	NNS
amendemen	NNS
amensalisme	NN
ametabola	VB
ametis	IN
amfetamin	NN
amfibi	NNS
amfibol	NN
amfibolisme	NNS
amfiteater	NN
amfoterik	NN
ami	WDT
amigdalin	NN
amil	NN
amilase	NN
amis	NNS
amit	WP
amnesti	NN
amonia	NN
amonifikasi	NN
amonium	NN
amor	NN
amorf	JJ
amortisasi	NN
ampas	NN
ampel	NN
ampisilin	NN
amplas	JJ
amplifikasi	NN
amplitudo	NN
amplop	NN
ampo	NN
amprok	NN
ampuh	JJ
ampuk	NN
ampul	NN
ampula	NN
ampun	NN
amputasi	NN
amril	NN
amsal	NN
amtenar	JJ
amuba	NN
amunisi	NN
ana	NN
anaerob	NNS
anaerobik	NN
anafilaksis	NN
anaianai	NNS
anak	NN
emas	NN
sungai	NN
tiri	NNS
anakronisme	NN
analgesik	JJ
analis	NN
analisis	NN
analitis	JJ
analogi	NNS
analsit	NN
anarki	NN
anarkis	NN
anarkisme	NN
anarkistis	JJ
anatomi	NN
anatomis	JJ
ancam	VBN
ancang	IN
anda	PRP
andai	IN
andam	NN
andan	NN
andang	NN
andapita	NN
andesit	NN
andika	NN
andiko	NN
andil	NN
andrawina	NN
andrologi	NN
aneh	NN
aneka	JJ
ragam	NN
anekdot	NNS
anemofili	NNS
anemograf	NN
anestesi	NN
anestesia	NN
aneurisme	NN
angga	NNS
anggap	VB
anggar	VBG
anggara	NN
anggota	NN
anggrek	NN
anggrekwan	NNS
angguk	NN
anggun	NN
anggur	NN
anggut	NN
angin	NN
angiologi	NNS
angit	NNS
angka	NNS
angkara	NN
angkasa	NN
angkat	NN
angker	VBN
angket	NN
angkuh	JJ
angkuk	NN
angkup	NNS
angkut	NN
angsa	NN
ani	NNS
aniani	NNS
aniaya	NN
anilina	NN
animasi	NN
animis	NNS
animisme	NN
animo	NN
anisogami	NN
anisokoria	NN
anjak	VBG
anjal	JJ
anjing	NN
anjlok	VBN
anoa	NN
anomali	NN
anonim	JJ
anonimitas	NN
anoreksia	NN
anorganik	NN
anotasi	NN
ansa	NN
ansambel	JJ
antagonis	NN
antagonisme	NN
antan	NN
antar	IN
antara	IN
bangsa	IN
benua	NN
daerah	IN
antari	NN
antariksa	NN
kelompok	IN
lingkungan	IN
master	NN
molekul	NN
muka	NN
negara	IN
planet	JJ
pribadi	JJ
pulau	NN
suku	NN
antartika	NN
wilayah	IN
antelas	IN
antelop	NN
antemeridiem	NN
antena	NN
anteng	NNS
antep	NNS
antibiotik	NNS
antibodi	NN
antidepresan	NN
antidioksida	NN
antidiuretik	JJ
antidot	NN
antiflogistik	NNS
antigravitasi	NN
antihistamin	NNS
antik	NN
antiklimaks	NN
antiklin	NN
antiklinal	NN
antiklor	NN
antikonsepsi	NN
antikristus	NN
antikuari	NNS
antikuariat	NNS
anting	NNS
antipati	NN
antipiretik	JJ
antipruritik	JJ
antisemitisme	NN
antiseptik	JJ
antisiklon	NNS
antisiklonal	JJ
antisiklonis	NN
antisipasi	NN
antisipatif	NN
antitesis	NN
antoi	VBD
antologi	NN
antonim	NN
antonimi	NN
antraknosa	NN
antraks	NN
antrasena	NN
antre	NN
antri	JJ
antropoda	NN
antropofagi	NNS
antropoid	NN
antropolog	NN
antropologi	NN
antroponimi	NN
antroposentris	NN
antroposentrisme	NN
antroposofi	NNS
antuk	NN
antul	NN
anturium	NN
antusias	JJ
antusiasme	NN
anual	JJ
anugerah	NN
anuitas	NN
anulir	NN
anumerta	JJ
anunasika	PRP
anyam	RB
anyang	NN
anyar	NN
anyelir	NN
anyir	NN
apa	WP
apabila	WRB
apakah	VBZ
apalagi	NN
apar	VB
aparat	NN
aparatur	NN
aparatus	NNS
apartemen	NN
apas	NN
apatah	RB
apati	NN
apatis	JJ
apatride	NN
apek	NN
apel	NN
apelativa	VBG
apendektomi	NN
apendiks	NN
apendisitis	NN
apersepsi	NN
apik	NN
apikal	JJ
apikultur	NN
apilan	NN
aplikasi	NN
aplikatif	JJ
apodal	NN
apoge	NN
apograf	NN
apok	NN
apokalips	NN
apokaliptik	JJ
apokope	NN
apokrifa	NN
apokromatik	JJ
apologia	NN
apopleksi	NN
aposematik	IN
aposisi	NN
apostasi	NN
apostel	NN
aposteriori	NN
apostolik	NN
apostrof	NN
apotek	NN
apoteker	NN
apotik	NN
apraksi	NNS
apraksia	NN
apresiasi	NN
apresiatif	JJ
aprit	NN
apu	NN
apung	NN
apuran	NN
ara	RB
arabes	NN
arabika	NN
arah	NN
arak	NN
aramba	PRP
arang	NN
aransemen	NN
ararut	NN
arau	NN
arbei	NN
arbitrase	NN
arbitrer	NN
arca	PRP$
arcas	NNS
argot	NN
argumen	NN
argumentasi	NN
argumentatif	JJ
ari	VBG
arif	NN
arifin	NN
aristokrasi	NN
aristokrat	NN
arit	NN
aritmetika	JJ
arja	NN
arkade	NN
arkais	NN
arkaisme	RB
arkati	NNS
arkeolog	NN
arkeologi	NN
arkeologis	JJ
arktika	JJ
arku	NN
arloji	NN
arogan	JJ
arogansi	NN
aromatik	JJ
arsenik	NN
arsip	NNS
arsir	VBG
arsitek	NN
arsitektur	NN
arta	DT
artefak	NNS
arteri	NN
arteriografi	NN
arteriosklerosis	NN
arti	NN
artifisial	RB
artikel	NNS
artikulasi	NN
artileri	NN
artis	NN
artistik	JJ
artona	NN
artropoda	NNS
arung	NN
arus	JJ
arwah	NNS
arwana	NN
aryaduta	NN
asa	RB
asak	NN
asal	NN
asali	NN
asam	NN
asan	JJ
asas	JJ
asbak	NN
asbes	NN
aseksual	JJ
aseptik	JJ
asetabulum	NN
asetat	NN
asetilena	NN
aseton	NN
asfiksia	NN
asi	IN
asibilasi	NN
asid	NN
asidosis	NN
asiklik	NN
asil	JJ
asimetris	NN
asimilasi	NN
asimilatif	JJ
asing	JJ
asisten	NN
asistensi	NN
askar	NN
askese	NN
askriptif	JJ
asli	JJ
asma	NN
asmara	NN
asonansi	NN
asong	NN
asosial	JJ
asosiasi	NN
asosiatif	JJ
aspal	NN
aspek	NN
aspiran	NN
aspirasi	NN
aspirat	NN
aspiratif	JJ
asrama	NN
asri	NN
astaga	NN
astaka	NN
astakona	NNS
astenia	NN
astenopia	NN
astringen	NN
astrofisika	NNS
astrolog	NN
astrologi	NN
astronautika	NNS
astronom	NNS
astronomi	NN
astronomis	JJ
asu	NN
asuh	NN
asumsi	NN
asumtif	JJ
asuransi	NN
asusila	JJ
aswa	NN
aswasada	NN
asyera	NNS
asyik	NN
atak	NN
ataksia	MD
atap	NN
atar	NNS
atas	IN
nama	NN
atase	NN
atau	CC
ateis	MD
ateisme	NN
atelir	NN
atensi	NN
atenuasi	NN
ati	PRP
atlet	NN
atletik	NNS
atma	NN
atmosfer	RB
atok	NN
atol	NN
atowa	PRP
atraksi	NNS
atraktif	JJ
atribut	NN
atributif	JJ
atrisi	VB
atrofi	NN
atropin	NN
atung	JJ
atur	NN
audiensi	NNS
audiologi	NN
augmentatif	JJ
auk	IN
auksin	NN
aula	NN
aur	NN
aurikularia	NN
aus	IN
auskultasi	NN
autad	NNS
autentik	JJ
autentikasi	NN
autisme	NN
autistik	JJ
autobiografi	NN
autodidaktik	NN
autogami	VBG
autograf	NN
autografi	NN
autogram	NN
autokrasi	NN
autokrat	NN
autokton	JJ
automobil	NN
automotif	JJ
autopsi	NN
autotoksin	NN
avesta	NN
avgas	NN
aviari	JJ
aviasi	NN
avokad	NN
avontur	NN
avonturir	JJ
avtur	NN
awa	NN
awaarang	NN
awabau	DT
awabeku	PRP
awabulu	VBP
awahama	NN
awak	PRP
awal	RB
awalengas	NN
awam	NN
awan	NN
awas	NN
awawarna	NN
awet	JJ
ayah	NN
ayahanda	NN
ayak	NN
ayal	NN
ayam	NN
ayar	NN
ayat	NN
ayo	VB
ayom	VBG
ayum	NNS
ayun	RB
azab	NN
azal	NN
azimat	NNS
ba	NN
bab	NN
babad	NN
babak	NN
baban	PRP$
babas	NNS
babat	NN
babatan	NN
babet	NNS
babi	NN
babit	NN
babon	NN
babut	DT
baca	NN
bacak	NN
bacek	NN
bacot	NN
bacul	NN
badai	NN
badak	NN
badam	NNS
badan	NN
badani	JJ
badar	NNS
badau	NNS
badui	NN
badut	NN
bagai	IN
bagaimana	WRB
bagal	NNS
bagasi	NN
bagat	VBN
bagau	NN
bagi	IN
baginda	DT
bagong	JJ
bagul	NN
bagus	JJ
bahagia	JJ
bahak	NN
bahan	NNS
bahana	NN
bahara	NN
bahari	NN
bahariwan	NN
baharu	JJ
bahas	NN
bahasa	NN
bahasawan	DT
bahaya	NN
bahenol	JJ
baheula	JJ
bahkan	RB
bahtera	NN
bahu	NN
bahuku	PRP$
bahwa	IN
bahwasanya	IN
baiat	NN
baid	NN
baik	JJ
bainah	NN
bajak	NN
bajan	VB
bajar	VB
baji	NN
bajik	JJ
bajing	NN
baju	NNS
bajul	NN
bak	IN
bakak	JJ
bakal	MD
bakap	VBN
bakar	NN
bakas	NN
lewu	JJ
bakat	NN
bakau	NN
bakelit	NN
bakero	NN
bakhil	NN
bakiak	NNS
bakik	NNS
bakir	NN
bakmi	NN
bako	NN
bakpao	NN
bakso	NNS
bakteremia	NN
bakteri	NNS
bakteriofag	NN
bakteriolisis	NN
bakteriolog	NN
bakteriologi	NN
bakti	NN
bakul	NN
bakung	NNS
bakut	VBG
bal	NN
balada	NN
balai	NN
balairung	NN
balak	NN
balang	NN
balans	NN
balap	VBG
balas	NN
dendam	NN
balau	NN
balen	NNS
balerina	NN
balet	NN
balgam	NN
baliho	NN
balik	IN
balistik	JJ
balistika	NNS
balkon	NN
balok	NN
balon	NN
balong	NN
balot	VBD
balseros	NNS
balu	NN
balung	NNS
balur	NN
balut	VBG
bambam	NN
bambu	NN
bambung	NN
ban	NN
bana	TO
banang	VBN
banar	NNS
bancar	NN
bancet	NN
banci	NNS
bancuh	NN
bancut	NN
banda	NN
bandar	NN
bandara	NN
bandea	NN
bandel	NN
bandela	NN
bandeng	NN
banderol	NNS
banditisme	NN
bando	NN
bandos	NNS
bandul	NN
bandusa	VBG
bangai	NNS
bangang	JJ
bangar	NNS
bangas	NNS
bangat	NN
bangau	NN
banget	RB
bangga	NN
bangkah	NN
bangkai	NN
bangkal	VBN
bangkang	NN
bangkar	NN
bangkas	NN
bangkasan	VBG
bangket	NN
bangkis	NN
bangkit	NN
bangkong	NNS
bangkot	JJ
bangkrut	NN
bangku	NN
bangkut	NN
banglo	NN
tolak	NN
bangpak	NN
bangsa	NN
bangsai	DT
bangsal	NN
bangsat	NN
bangsawan	NN
bangsi	NN
bangun	VB
bani	NN
banian	NN
baning	WP
banir	TO
banjang	NN
banjir	NN
banjur	RB
bankir	NN
bantah	NN
bantai	NN
bantal	NN
bantar	NN
bantaran	NN
bantat	VBN
bantau	NN
banteng	NN
banting	NN
bantu	NN
bantun	NN
bantut	VBN
banyak	JJ
banyo	NN
banyol	NN
banyun	NN
bao	NN
bapa	NN
bapak	NN
bapakisme	NN
baplang	JJ
baptis	NN
bara	RB
barah	NN
barai	NNS
barang	NNS
barangkali	RB
barat	NN
barbarisme	NN
barel	NN
bareng	IN
barep	JJ
baret	NN
barier	NNS
barik	IN
barikade	NNS
baringan	NNS
baris	NN
barit	NN
bariton	NN
barjad	NNS
barok	NN
barometri	NN
barongsai	NN
baru	JJ
barua	NN
barusan	RB
barut	NN
bas	JJ
basa	NN
basah	NN
basalioma	NN
basat	VBN
basi	NN
basilari	JJ
basilika	NN
basilus	NN
basit	NN
baskom	NN
basmi	IN
basuh	NN
basung	NN
bata	NN
batai	NNS
batako	NN
batal	NN
batalion	NN
batara	NN
batas	NN
batekeng	NN
batela	IN
baterai	NN
bati	TO
batih	VBN
batil	JJ
batila	TO
batin	NN
batiplankton	NN
batis	NN
batok	IN
batu	NN
batuk	NN
batun	NN
batung	NN
bau	NN
bauk	NN
baun	NN
bausuku	NN
baut	NNS
bawa	NN
bawab	NN
bawah	IN
bawang	NN
bawat	DT
bayak	NN
bayam	NN
bayan	NN
bayang	NN
bayar	NN
bayas	NNS
bayata	NN
bayem	NN
bayi	NN
bayuh	NN
bayur	NN
beasiswa	NN
beban	NN
bebas	JJ
murni	NN
tugas	NN
bebek	NN
beber	NN
beberapa	DT
bebesaran	NN
bebi	NN
bebotoh	NN
bebrek	NN
becak	NN
becek	NN
becus	NN
beda	JJ
bedah	NN
bedak	NN
bedebah	NN
bedegong	JJ
bedel	NN
bedeng	NNS
bedil	NN
bedinde	IN
bedudak	NN
beduk	NN
bedukang	NN
begadang	NN
begah	RB
begal	NN
begana	VBD
begap	NN
begini	IN
begitu	RB
bego	JJ
begu	NN
beguk	NN
behandel	NN
behena	NN
bejana	NN
bejat	VBN
bek	NN
beka	NN
bekal	NN
bekam	VBD
bekas	JJ
bekat	NN
bekatul	NN
beken	JJ
beker	NN
bekicot	NN
bekil	NNS
bekleding	VBG
beku	NNS
bekuk	NN
bekuku	PRP
bela	NN
belada	IN
beladau	DT
belah	NN
belahak	NN
belaka	RB
belakang	RB
belako	IN
belalah	VB
belalai	NN
belalak	VBN
belalang	NNS
belan	NN
belanda	NNS
belandang	NN
belandar	NN
belang	NN
belangah	NN
belangir	JJ
belangkas	NN
belangkin	NN
belangkon	NN
belanja	NN
belantara	NN
belantik	NN
belantuk	NN
belar	NN
belas	NN
belasah	NN
belasting	NN
belasungkawa	NNS
belasut	NN
belat	NN
belati	NN
belatuk	NN
belatung	NNS
beleda	NN
beledi	RB
beledu	NN
beleid	NN
belekek	NNS
belekok	NN
belelang	NN
belembang	NN
belenggu	NNS
belengket	NN
belengkong	NN
belepas	NN
belerang	NN
beli	VB
belia	NN
beliak	NNS
beliau	PRP
belibis	NN
belida	IN
beligat	NN
belikan	VBN
belikat	NNS
beliku	PRP$
belimbing	NN
beling	NN
belingkang	NN
belinjo	NN
beliung	NN
beliut	NN
beloan	NN
belok	NN
belolok	VBG
belolong	VBG
belon	NN
beloon	VBN
belotong	VBN
belu	NN
beluam	DT
beluas	RB
belubur	NN
beludak	NN
beludar	DT
beluhan	NN
beluk	NNS
belukap	VBN
belukar	NN
beluku	PRP$
belukut	NN
belulang	NNS
beluluk	NN
belulung	NNS
belum	RB
belungkang	JJ
belungsing	NN
belusuk	NN
belut	NN
bembam	NN
bemper	NN
benah	NNS
benak	NN
benam	NN
benang	NN
benar	NN
benatu	VBN
bencah	NN
bencana	NN
benci	NN
benda	NN
bendahara	NN
bendaharawan	NN
bendahari	NN
bendang	NN
bendara	NN
bendawi	RB
bende	PRP
bendela	NN
bendera	NN
benderang	NNS
benderung	VBG
bendi	NN
bendir	NNS
bendo	NN
bendoro	NN
bendu	NN
bendul	NN
bendung	NN
bengang	JJ
bengek	NN
benggal	NN
benggala	NN
benggang	JJ
benggil	NN
benggol	NN
bengis	NN
bengkak	NN
bengkal	NN
bengkalai	NN
bengkarak	NN
bengkatak	NNS
bengkel	NN
bengkeng	NN
bengkil	NN
bengkok	NNS
bengkuang	NN
bengong	VBN
bengot	VBN
bengu	NN
benguk	NN
bengul	NN
beni	PRP
benih	NN
bening	JJ
benitan	VBN
benjol	NNS
bensin	NN
benta	NNS
bentak	VBD
bentan	DT
bentang	NN
bentangkan	NN
bentangur	VBN
bentar	DT
bentara	DT
benteng	NN
bentik	JJ
bentoh	NN
bentol	NNS
bentonit	NN
bentrok	VBG
bentuk	NN
bentur	NNS
benturung	NN
benua	NN
benur	NN
benyot	NN
benzedrin	DT
benzena	NN
benzoat	NN
benzoil	NN
peroksida	NN
benzol	NN
beo	NN
bera	NN
berabe	NN
berahi	VB
berak	PRP
berakah	NN
beraksa	VBN
berambang	VBG
beramin	NN
beranda	VB
berandal	NN
berandang	VB
berang	VB
berangai	NN
berangan	NNS
berangas	NN
berangkal	NN
berangkat	VB
berangus	NN
berani	VB
berantak	NN
berantas	VB
berapa	WRB
beras	NN
berat	NN
bercak	VBG
berdikari	VB
berdus	VB
berebes	VB
beremban	VB
berembang	VBG
berentang	JJ
beres	VB
berewok	NN
berguk	NN
beri	IN
tahu	VB
beril	VB
berilium	NN
beringas	NN
beringin	VB
beringsang	NN
berisik	VB
berita	NN
beritawan	VB
berkah	VB
berkas	VB
berkat	NNS
berkik	VBG
berlian	VB
bernas	VB
beroci	VB
beronang	VB
berondong	NN
berong	NN
berongkos	VB
berongsong	IN
beronjong	VBN
berontak	JJ
berosot	NN
beroya	VB
bersat	NN
bersih	VB
bersin	VBG
bersut	VBN
bertih	RB
beruas	VBZ
berubuh	VBN
berujul	NN
beruk	NN
berus	NN
besan	NN
besar	JJ
besaran	NN
besek	NN
besengek	VBN
besero	NN
besi	NN
tua	PRP$
besing	VBG
besit	NN
beslit	NN
besok	NN
besot	VBN
bestek	NN
bestel	NN
besuk	NN
betah	NN
betapa	WRB
betari	NN
betet	NN
beti	RB
betik	NN
betina	NN
beting	VBG
betinga	JJ
betok	NN
beton	NN
betonisasi	NN
betot	NN
betul	NN
betung	NN
bi	IN
biadab	NN
biadat	NN
biah	NN
biak	DT
biang	DT
biar	VB
biara	NN
biarawan	NN
biarawati	NN
biarpun	RB
biasa	JJ
biat	NN
biau	NNS
biawak	NN
biawan	NN
biaya	NN
bibel	JJ
bibir	NN
bibit	NNS
bibliografi	NN
bibliotek	NN
bicana	NN
bicara	NN
bicu	NN
bida	NN
bidadari	NN
bidah	NN
bidai	NN
bidak	NNS
bidal	NN
bidan	NN
bidang	NN
bidik	NN
biduan	NN
biduanda	NN
biduk	DT
bienial	NN
bigami	NN
bihun	NN
bija	PRP
bijak	NN
bijaksana	NN
bijana	NN
biji	NN
bijih	NN
bikang	NNS
bikarbonat	NN
bikin	VB
bikir	VB
bikromat	NN
biksah	JJ
biksu	NN
bila	VBD
bilah	NNS
bilai	NN
bilamana	WRB
bilamasa	WRB
bilang	IN
bilas	NN
bilga	VB
bilhak	NN
biliar	NN
bilik	NN
bilis	NN
biliun	NN
bilur	NN
bimasakti	NN
bimbang	JJ
bimbit	NN
binar	NN
binaraga	NN
binaragawan	NN
binasa	VBN
binatang	NNS
bincacak	MD
bincang	NN
bindam	NN
bindeng	NN
binen	NN
biner	NN
bingas	NN
bingit	NN
bingka	NN
bingkah	NN
bingkai	NN
bingkas	NN
bingkatak	NN
bingkis	DT
bingung	VBN
binokular	NNS
bintal	NN
bintalak	VBN
bintang	NN
bintara	VBN
binti	NNS
bintik	NNS
bintil	NN
biodin	NN
biofisik	JJ
biofisika	NNS
biogeografi	NN
biografi	NN
biokimia	NN
bioklimatologi	NN
biola	NN
biolinguistik	NNS
biolog	NN
biologi	NN
biologis	JJ
biomassa	NN
biometri	NNS
biometrika	NNS
biopsi	NN
bioritme	NN
bioritmik	NN
biosfer	RB
biosida	NNS
bioskop	NN
biotek	NN
bioteknologi	NN
biotik	JJ
bipatride	VBG
bipolaritas	NN
bir	CD
birai	NN
biram	NN
birama	NN
birang	NN
birat	VBN
birit	NN
biro	NN
birokrasi	NN
birokrat	NNS
birokratis	JJ
birokratisasi	NN
birokratisme	NN
birsam	NN
biru	NN
bis	TO
bisa	MD
bisai	NN
bisawab	NN
bisbol	NN
biseksual	JJ
bisektris	NN
bisik	VBD
bising	NN
bisinosis	NN
biskuit	NNS
bismut	NN
bisnis	NN
bissu	RB
bistik	NN
bisu	NN
bisul	NNS
biti	VB
biumbai	NN
bius	VBN
biut	NN
bivak	NN
blakblakan	NN
blangko	NN
blantika	NN
blek	NN
blekek	NN
blewah	NN
bloger	NN
blokade	NNS
blokir	NN
blong	JJ
blus	NN
blustru	NN
bobok	NN
bobol	NN
bobot	NN
bobrok	VBN
bocah	NN
bocok	NN
bocor	VBN
bodi	VB
bodoh	JJ
bodok	NN
bodong	NN
bodor	NN
boga	NN
bogel	NN
bogi	NN
bohlam	NN
bohong	NN
boikot	NN
bois	NN
bokar	VBG
bokca	NN
bokong	NNS
bokor	NN
boksen	NN
bokser	NN
bokset	NN
boksu	NN
boku	NN
bol	PRP
bola	PRP
bolak	RB
boleh	MD
bolide	NN
bolong	NN
bolos	NNS
bolotu	NN
bolpoin	NN
bolu	VBN
bom	JJ
bombai	NN
bombardir	NN
bombas	NNS
bombastis	JJ
bomseks	NN
bon	JJ
bonafiditas	NN
bonbon	NN
boncol	VB
bondol	NNS
bondong	VBN
boneka	NN
bonet	NN
bonggol	NN
bongkar	VBG
bongsang	VBN
bonjol	NN
bontak	NN
bopeng	NNS
bopok	NNS
bor	JJ
boraks	NN
borang	NN
borci	NNS
bordes	NNS
bordil	NN
bordir	NN
borgol	NNS
borjuasi	NN
borjuis	NN
borok	NNS
borong	NN
boros	NN
bos	NN
bosan	VBN
boseta	NN
botak	NN
botang	NNS
botani	JJ
botanikus	NN
botelir	NN
boto	NN
botok	NNS
botol	NN
botor	NN
botulisme	NN
boya	NN
boyak	NN
boyas	NNS
brakiurus	VBG
brana	NN
brander	NN
brankas	NN
branwir	NN
braseri	NNS
brata	NN
bratawali	NN
breksi	NN
brendi	NN
brengsek	NN
brevet	NN
brigadir	NN
briket	NNS
brilian	NN
briofita	NNS
briologi	NNS
brisan	VBN
brokade	NN
brokat	NN
brokoli	NN
bromat	NN
bromida	NN
bromin	NN
bronkioli	NN
bronkitis	NN
bronkus	NN
brosur	NN
bruder	NNS
bruk	NN
brutalisme	NN
bruto	JJ
bu	PRP
tanah	NN
buah	NN
bual	NN
buang	NN
buar	NN
buari	NN
buas	NN
buat	NN
buaya	NN
bubar	VBN
bubuh	NN
bubuhan	NN
bubuk	NN
bubul	NN
bubur	NN
bubut	NN
budak	NN
budanco	NN
budaya	NN
budayawan	NN
buddhisme	NN
bude	MD
budi	NN
daya	NN
budian	NN
budiman	NN
budu	NN
buduk	NN
budur	DT
bufet	NN
bugar	NN
bugil	JJ
buhuk	NN
buhul	JJ
buih	NN
bujang	JJ
bujangga	NN
bujet	NN
bujuk	NN
bujur	NN
bujut	NN
buka	JJ
bukan	RB
bukau	VB
buklet	NN
bukti	NN
buku	NN
bukung	DT
bukur	RB
bulai	NN
bulan	NN
bulang	NN
bulangan	NNS
bular	DT
bulat	NN
buldan	TO
buldog	NN
buldoser	NN
buleng	NN
buletin	NN
bulgur	NNS
bulir	DT
bulsak	IN
bulu	NN
tangkis	NN
bulubulu	NNS
buluh	NN
bulur	NNS
bumbu	NNS
bumbun	NN
bumbung	NN
bumerang	NN
bumi	NN
hangus	VBN
rata	JJ
bumiah	RB
bumpet	CC
bun	JJ
buna	NN
buncah	NN
buncis	NN
buncit	VBN
bunda	NN
bundar	NN
bundas	NNS
bundel	NN
bunduk	NN
bundung	NN
bunga	NN
bungkam	NN
bungkas	NN
bungker	NN
bungkil	NN
bungking	NN
bungkuk	JJ
bungkul	NN
bungkus	NN
bunglon	NN
bungsu	JJS
buni	NN
bunian	NNS
buntak	VB
buntar	NN
buntek	NN
buntel	NNS
buntil	NN
buntu	JJ
buntung	NN
buntut	NN
bunuh	NN
bunyi	NN
bupet	NN
buraksa	NN
buram	NN
buras	NNS
burayak	VBN
buret	NN
burhan	NN
burit	VBD
buron	JJ
bursa	NN
buru	NN
buruh	NNS
buruj	NN
buruk	JJ
burung	NN
burut	NN
busa	NN
busai	NN
busana	NN
busi	NN
busik	NN
busuk	VB
busung	NN
busur	NN
busut	NN
buta	NN
butadiena	NN
butala	NN
butang	NN
butek	NN
butik	NN
butir	NNS
butongpai	NN
butuh	NN
butun	DT
butut	JJ
buyar	VBN
buyung	NN
buyur	VBN
buyut	NN
ca	IN
cabai	NN
cabak	NN
cabang	NN
cabar	NN
cabe	NN
cabik	NNS
cabo	NN
cabuh	NN
cabuk	RB
cabul	NN
cabut	NN
caca	NN
cacah	NN
jiwa	NN
cacap	NN
cacar	NN
cacat	JJ
cacau	NN
caci	IN
cacing	NN
cadang	NN
cadar	NN
cadas	NN
cadik	NN
cadung	NN
caem	NN
cagak	NN
cagar	NN
caguh	JJ
cahaya	NN
cair	NN
cais	NN
caisim	NNS
cak	RB
cakah	NN
cakalang	NN
cakap	VB
cakar	NN
cakep	NN
cakra	NN
cakram	NN
cakrawala	DT
cakup	NN
cakus	NN
caladi	NN
calar	NN
calit	VBN
calo	NN
calon	NN
calui	NN
caluk	NN
camau	NNS
cambahan	NN
cambuk	NN
cambul	NN
campa	NN
campah	NN
campak	NNS
campuh	NN
campung	NN
campur	NN
camur	NN
canda	NNS
candai	NN
candak	VBN
candit	NN
candu	NN
candung	NN
cangcang	NN
canggaan	NN
canggai	NN
canggal	VBN
canggih	JJ
canggung	NN
cangkang	NN
cangkih	NN
cangkir	NN
cangkok	NN
cangkrang	NN
cangkriman	NN
cangkul	NN
cangkum	NN
cangkung	DT
cangkup	NN
canguk	NN
cantas	WRB
cantik	NN
canting	VBG
cantum	NN
caos	NN
capa	NN
capai	VBN
capak	NN
capek	VBN
capil	NN
caplak	NN
capuk	NNS
capung	NN
cara	NN
caraka	NN
caram	NN
caran	RB
cari	NN
carik	NN
caruk	JJ
carut	NN
cas	NN
catat	NN
catu	NN
catuk	NN
catur	NN
caturwulan	NN
catut	NN
caung	NN
cawai	NN
cawak	NN
cawan	NN
cawangan	NN
cawat	NNS
ce	DT
cebik	NN
cebikas	NN
cebil	NNS
cebir	NN
cebol	NN
cebong	NN
cebur	NN
cecah	VB
cecak	NN
cecar	NN
ceceh	NN
cecok	NN
cecunguk	NN
cedera	NN
cedong	NN
ceduk	NN
cegah	NN
cegak	JJ
cegar	NN
cegat	NN
cek	NN
cekah	NN
cekak	JJ
cekakan	NN
cekal	NN
cekam	VBG
cekat	NN
cekau	NN
cekcok	NN
cekdam	NN
cekek	NN
cekel	VB
ceker	NN
cekibar	NN
cekih	NN
cekik	NN
cekikik	NN
cekit	NN
ceklek	NN
cekluk	NN
cekok	NN
cekuh	JJ
cekuk	NN
cekung	NN
cekup	NN
cekur	VBN
cekut	NN
cela	PRP
celah	NN
celak	DT
celaka	NN
celampak	NN
celana	NNS
celangak	NN
celangap	RB
celapak	NN
celar	TO
celari	NNS
celas	VBZ
celat	NNS
cele	DT
celek	JJ
celekeh	NN
celemek	NN
celempung	NN
celeng	NN
celengkang	VBG
celepik	NN
celepuk	NN
celetuk	NN
celi	JJ
celih	JJ
celik	NN
celonok	NN
celoteh	JJ
celung	NNS
celup	NN
celur	NN
celurut	NN
celutuk	VBN
cema	DT
cemar	NN
cemara	NN
cemas	JJ
cemberut	NN
cembung	NN
cemburu	JJ
cemeh	DT
cemek	TO
cemerlang	NN
cemeti	NN
cemong	NN
cemooh	NN
cempa	NN
cempal	NN
cempala	NN
cempedak	NN
cempek	NN
cempeng	NN
cempreng	NN
cempung	NN
cemuas	NNS
cemuk	NN
cena	NN
cenak	NN
cencawan	JJ
cendala	NN
cendana	NN
cendang	NN
cendawan	NNS
cendekia	NN
cendekiawan	NN
cenderung	NN
cendok	NN
ceng	NN
cengam	NN
cengang	NN
cengbeng	NN
cengek	DT
cengeng	NN
cenggek	NN
cengger	NN
cenggeret	NN
cengkal	NN
cengkam	NN
cengkar	VBN
cengkedi	NN
cengkeh	NN
cengkeram	NN
cengkerama	NN
cengkerawak	NN
cengkerik	NN
cengkering	NNS
cengki	VBN
cengkiak	NN
cengkih	NN
cengking	VBG
cengkir	NN
cengkok	NNS
cengkong	NNS
cengkung	NN
cengkurai	NN
cengli	NN
cengung	VBG
centang	NN
centangan	NN
centet	NNS
centong	NN
cepak	VBG
cepal	NN
cepat	NN
cepengan	NN
ceper	JJ
cepiau	NN
ceples	JJ
cepo	NNS
cepuk	NN
cerabih	NN
cerabut	NN
ceracak	MD
ceracam	RB
ceracau	NN
cerah	NN
cerai	NN
ceraka	NN
ceramah	NN
cerang	NN
ceranggah	NN
cerangka	NNS
cerap	NN
ceratai	NN
ceratuk	VBN
cerawat	NN
cerbak	NN
cerca	NN
cercah	VBG
cercak	NN
cercap	VBG
cerdas	NN
cerdik	NN
cere	NN
cerek	NN
cerewet	NN
cergas	NN
ceri	NN
ceria	NN
cerih	JJ
cerita	NN
cerkau	JJ
cerlang	JJ
cerlih	NN
cermai	NN
cermat	NN
cermin	NN
ceroboh	NN
cerobong	NN
cerocok	NN
cerocos	NN
cerompong	NN
ceronggah	NN
ceropong	DT
ceroteh	JJ
cerpelai	NN
cerpen	JJ
cerpenis	JJ
cerucuh	DT
cerucup	NN
ceruh	NN
ceruk	NN
cerun	NN
cerup	DT
cerut	VBN
cerutu	NN
cetai	CD
cetak	NN
cetar	VBG
cetek	NN
ceteri	NNS
ceteria	NN
ceti	NNS
cewang	NN
cewek	NN
ci	PRP
ciak	NN
cialat	NN
cibir	TO
cibit	NN
cibuk	JJ
cicik	NNS
cicip	NN
cicit	NNS
ciduk	NN
cih	NN
cihui	NN
cik	WRB
cikar	NN
cikok	NN
cikrak	,
cikun	NN
cili	WP
cilik	JJ
cina	NN
cincang	NN
cincin	NN
cincong	NN
cindil	NN
cindur	NN
cingak	VBN
cingkat	NN
cinta	NN
cinteng	NN
cip	NN
cipai	NN
cipan	NN
ciplak	JJ
ciprat	NNS
cipta	NN
circir	TO
ciri	JJ
cirit	NN
cita	NN
citra	NN
ciu	NN
cium	NN
ciut	RB
coba	NN
cocok	JJ
tanam	VBG
cocor	NN
codot	NN
cok	RB
cokelat	NN
coket	NNS
coklat	NN
cokok	NN
colek	NN
colet	NN
colok	NN
comblang	NN
comel	NN
comot	NN
comro	NN
condong	JJ
congek	NN
congget	NN
congki	VBG
congklang	NN
congkong	NN
congsam	NN
conteng	JJ
contoh	NN
contong	NN
copet	NN
coplok	VB
copot	VBN
corak	NN
corek	NN
coreng	NN
coret	NN
coro	NN
corong	NNS
cotet	NN
cotok	NN
cowok	NN
cowokan	VB
cua	NN
cuaca	NN
cuai	NN
cuak	NN
cual	WDT
cuar	VBG
cuci	NN
cucu	NN
cucuh	VB
cucuk	NN
cucun	NN
cucunda	NN
cucup	NN
cucur	NN
cudang	NN
cuek	NN
cuit	NNS
cuk	NN
cuka	NN
cukai	NN
cuki	NN
cukimai	NN
cukup	RB
cukur	VBG
culak	NN
culas	NNS
culik	NN
culun	NN
cuma	RB
cumepak	JJ
cumil	NN
cun	IN
cundang	NN
cunduk	NNS
cung	NN
cungap	NN
cungkil	JJ
cungkup	NN
cungo	NN
cungul	NN
cungur	NN
cupang	NN
cuping	NN
cupu	NN
cupul	NN
cura	NN
curah	NN
curam	VB
curang	VBG
curat	NN
cureng	NN
curi	NN
curiga	JJ
curik	NN
cuti	NN
da	VBZ
daba	NN
dabat	VBD
dabing	VBG
dabit	VB
dabol	NN
dabus	NN
dacin	NN
dada	NN
dadah	NNS
dadaisme	NN
dadi	NN
dadih	NN
dading	VBG
dadu	NN
daduh	NN
daduk	NN
dadung	NN
daerah	NN
daerahisme	NN
daftar	NN
hitam	JJ
daga	NNS
dagang	NN
dage	NNS
dagel	NN
dagi	IN
daging	NN
dagu	NN
dahaga	NN
dahagi	RB
dahak	NN
dahan	NNS
dahar	RB
dahi	RB
dahiat	NN
dahsyat	JJ
dahulu	RB
daidan	NN
daim	RB
daitia	NN
daka	NN
daki	IN
dakik	PRP
dakron	NN
daktil	NN
daktilologi	DT
daktiloskopi	JJ
dakwa	NNS
dakwah	VBG
dalalah	NN
dalalat	JJ
dalam	IN
dalih	NN
dalil	NN
dalu	NN
damai	NN
damak	NN
damar	NN
damas	NNS
damat	NN
dambin	NN
dambir	NN
damen	NNS
dami	NN
dampak	NN
dampan	NN
dampar	DT
dampil	VB
dan	CC
danau	NN
danawa	NN
danda	NN
dandan	NN
dandang	NN
dandanggula	NN
dangai	NN
dange	NN
dangkal	NN
dangkar	NN
dangkung	NN
dansa	NN
danta	NN
danuh	NN
dapar	NN
dapat	MD
dapra	NN
dapur	NN
dar	CC
darab	NN
darah	NN
darat	NN
darau	NN
dari	IN
mana	WRB
sana	PRP
sini	RB
daripada	IN
darmabakti	VBN
darmasiswa	NN
darmawisata	NN
daro	VBZ
darpana	NN
darurat	NN
darusalam	NN
darwis	NN
das	DT
dasalomba	VB
dasar	JJ
dasawarsa	NN
dasbor	NN
dasi	NN
daster	NN
datang	VB
datar	JJ
dati	NNS
datif	NN
datu	NNS
petinggi	JJ
datum	NN
daulat	JJ
daun	NN
nasi	PRP$
daur	NN
ulang	VBN
dawai	NNS
dawan	NN
guna	NN
upaya	NN
dayu	NN
dayuh	NN
dayung	NN
de	IN
dealat	NN
deaneksasi	NN
debah	NN
debak	NN
debam	NN
debarkasi	NN
debas	PRP
debat	NN
debet	MD
debing	VBG
debirokratisasi	NN
debitor	NN
debitur	NN
debu	NN
debur	VBG
decak	NN
decit	IN
dedah	VBN
dedak	NN
dedare	NN
dedas	NN
dedau	NN
dedek	NN
deder	NN
dedikasi	NN
dedikatif	NN
deduksi	NN
deduktif	NN
defaitisme	NN
defekasi	NN
defensi	NNS
defensif	NN
definisi	NN
definit	VBN
definitif	JJ
defisien	NN
defisit	NN
deflagrasi	NN
deflasi	NN
defleksi	NN
defonologisasi	NN
deforestasi	NN
deformasi	NN
deg	PRP
degan	CC
degar	NNS
degen	NN
degenerasi	NN
degeneratif	NN
degil	RB
deging	VBG
degradasi	NN
degresi	NN
degum	NN
dehem	NN
dehidrasi	NN
dehidrat	NN
dehidrogenasi	NN
deifikasi	NN
deiksis	NN
deislamisasi	NN
deisme	NN
dek	NNS
dekade	NNS
dekaden	NNS
dekadensi	NN
dekak	NN
dekam	NN
dekameter	NN
dekan	NN
dekanal	NN
dekap	VBG
dekar	NNS
dekat	RB
dekik	NN
dekil	NN
deklamasi	NN
deklamator	NN
deklarasi	NN
deklaratif	NN
deklasifikasi	NN
deklerer	NNS
deklinasi	NN
deklinometer	NN
dekode	NN
dekoder	NN
dekolonisasi	NN
dekomposer	NN
dekomposisi	NN
dekompresi	NN
dekongestan	NN
dekonsentrasi	NN
dekontekstualisasi	DT
dekor	NN
dekorasi	NN
dekoratif	NN
dekorator	NN
dekreolisasi	NN
dekret	NN
dekstrin	NN
dekstrosa	JJ
deksura	NN
deku	NN
dekunci	RB
dekus	NNS
delan	NN
delapan	CD
delas	IN
delat	NN
delegasi	NN
delegat	NN
delegitimasi	NN
deler	NNS
delik	NN
delikat	RB
delikates	NNS
delima	NN
delinkuen	NN
delu	NN
delusi	JJ
demabrasi	NN
demagog	NN
demagogi	NNS
demam	NN
demang	NN
demarkasi	NN
dembun	NN
demek	VB
demikian	RB
demiliterisasi	NN
demisioner	VBG
demografi	NNS
demografis	JJ
demokrasi	NN
demokrat	NNS
demokratis	JJ
demokratisasi	NN
demonstran	NNS
demonstrasi	NN
demonstratif	NN
demonstrativa	NN
demoralisasi	VBN
demosi	NN
dempak	NN
dempam	PRP
demper	NN
dempet	VBN
dempir	TO
demplon	RB
dempul	NN
dempung	NN
den	DT
dena	NN
denah	NN
denai	NN
denak	DT
denasalisasi	NN
denda	NN
dendeng	NN
dendi	PRP
dengan	IN
dengar	NN
dengkang	NN
dengkel	NN
dengki	NN
dengkik	JJ
dengking	VBG
dengkol	JJ
dengkul	NN
dengkung	VBN
dengkur	VBG
dengkus	NN
denguk	NN
dengung	NN
dengus	NN
denok	PRP
denominal	NN
denominasi	NN
densitas	NN
dentang	NN
dentat	VBN
dentur	VB
denuklirisasi	NN
denyar	NN
denyut	NN
deodoran	NN
deontologi	NNS
depak	NN
depan	NN
deparpolisasi	NN
departemen	NN
dependen	NN
dependensi	NNS
depilasi	NN
deplesi	NN
depolarisasi	DT
depopulasi	NN
deportasi	NN
deposan	NNS
deposito	NN
depresi	NN
depresiasi	NN
deprok	NN
depun	VBN
depus	VBN
deputasi	NNS
deputi	NN
dera	PRP
deragem	VBG
derajang	NN
derajat	NN
derak	NN
deram	VBD
deran	DT
derana	DT
derap	NN
deras	PRP$
derau	NN
derawa	DT
derebar	NN
deregulasi	NN
deres	PRP$
deresi	NN
deret	NN
deris	NN
derit	NN
derita	VBG
derivasi	NN
derivat	JJ
derivatif	NNS
derma	NN
dermaga	NN
derman	NN
dermatolog	NN
dermatologi	NNS
dermawan	JJ
dersik	NN
derung	NN
derus	PRP
desa	NN
desah	NN
desain	NN
desainer	NN
desak	VBD
desakralisasi	NN
desalinasi	NN
desar	VB
deselerasi	DT
desember	NN
desentralisasi	NN
desersi	NN
desertir	NNS
desibel	NN
desidua	JJ
desiliter	NN
desimal	NN
desinens	NNS
desinfeksi	NN
desinfektan	NN
desis	NN
desit	NN
deskripsi	NN
deskriptif	NN
deskuamasi	NN
desmonem	NN
desorientasi	NN
despotisme	NN
destabilisasi	NN
destar	TO
destinasi	NN
destruksi	NN
destruktif	NN
detak	NNS
detar	NN
detasemen	NN
detasir	NNS
deteksi	NN
detektif	NN
detektor	NN
detenidos	VBN
detensi	NN
detergen	NN
determinan	NN
determinasi	NN
determinis	VBN
determinisme	NN
detik	NNS
detoksifikasi	NN
detus	NN
deuterokanonika	NNS
devaluasi	NN
deviasi	NN
devisa	JJ
devosi	NN
dewa	NN
dewala	DT
dewan	NN
dewana	NN
dewasa	NN
dewata	NNS
dewi	NN
di	IN
dia	NN
diafon	NN
diaforetik	NN
diafragma	NN
diagnostik	NNS
diaken	NN
diakon	NN
diakones	NN
diakritik	NNS
dialek	NN
dialektik	JJ
dialektika	NNS
dialektis	JJ
dialisis	NN
dialogis	JJ
diam	NN
diamorf	NN
dian	JJ
diapositif	NN
diare	NN
dias	NNS
diat	NN
diatermi	NN
diatermik	NN
diatesis	NN
diatomit	NN
diatopik	NN
dibasa	NN
didaktik	NNS
didaktikus	JJ
didih	VBG
didik	NN
didis	JJ
didong	NN
dielektrik	NN
dietetika	NNS
difabel	JJ
diferensial	NN
diferensiasi	NN
difraksi	NN
difteri	NN
diftong	NN
difusi	NN
digestif	NN
digitalin	NN
digitalisasi	NN
digul	NN
dik	IN
dikara	NN
dikau	PRP
dikit	JJ
diklorida	NN
dikotil	VBN
dikotomi	NN
dikroisme	NN
dikromat	NN
diksi	NN
diktator	NN
diktatorial	NN
dikte	NN
diktum	NN
dil	DT
dila	NN
dilatasi	NN
dilema	NN
dilematik	NN
diler	NN
diluvium	NN
dimensi	NNS
diminutif	NN
din	IN
dina	PRP$
dinamik	JJ
dinamika	NNS
dinamis	JJ
dinamisator	NN
dinamisme	NN
dinamit	NN
dinamo	NN
dinamometer	NN
dinasti	NN
dinding	NN
dingin	NN
dini	JJ
dinosaurus	NN
dioksida	NN
dioksin	NN
dioptri	NN
dioses	NNS
dipan	NN
diplomasi	NN
diplomatik	JJ
diplomatis	JJ
diraja	NN
direk	NN
direksi	NNS
direktorat	NN
direktorium	NN
direktris	NN
direktur	NN
dirgahayu	NN
dirgantara	NN
diri	NN
dirigen	JJ
diris	VBD
dirus	NN
disagio	NN
disakarida	NN
disekuilibrium	NN
disensus	NN
disentri	NN
disertasi	NN
disfonia	NN
disfungsi	NN
disharmoni	NN
disiden	NN
disimilasi	NN
disinfektan	NN
disinsentif	NNS
disintegrasi	NN
disiplin	NN
disket	JJ
disko	NN
diskoid	NN
diskon	NN
diskontinu	NN
diskontinuitas	NN
diskonto	NN
diskotek	NN
diskredit	VBN
diskresi	NN
diskriminasi	NN
diskriminatif	NN
diskriminator	NN
diskualifikasi	NN
diskulpasi	TO
diskus	NNS
diskusi	NN
disleksia	NN
dislokasi	NN
disolventia	NN
disonansi	NN
disoperasi	VBN
disorientasi	NN
disosiasi	NN
dispareunia	NN
disparitas	NN
dispensasi	NN
dispepsia	NN
dispersi	VBG
disposisi	NN
distikiasis	NN
distilasi	NN
distoma	NN
distorsi	NN
distribusi	NN
distrik	NN
disuasi	NN
dito	RB
ditransitif	NN
diuretik	JJ
divergen	VBG
divergensi	NN
diversifikasi	NN
divestasi	NN
dividen	NN
divisi	NN
doa	NN
dobel	RB
dobi	NN
doble	RB
dobrak	VBN
dodot	VBG
dogmatik	NNS
dogmatis	JJ
dogmatisme	NN
dok	IN
dokar	NN
doksologi	NN
dokter	NN
doktor	NN
doktoranda	NN
doktorandus	JJ
doktrin	NN
doku	NN
dokumen	NN
dokumentasi	NN
dokumenter	NNS
dol	RB
dolar	NN
dolok	NN
dom	NN
domein	NN
domestik	JJ
domestikasi	NN
dominan	NN
dominasi	NN
domine	VBN
dominggo	NN
domisili	NN
dompak	RB
dompet	NN
dompol	NN
donasi	NN
donat	VBN
donatur	NNS
donder	NN
dong	NN
dongak	NN
dongan	NN
dongeng	NN
dongkak	NN
dongkok	JJ
dongkol	NN
dongkrak	NN
dongpan	NN
doni	NN
dopis	NN
dor	NN
dorang	PRP
dormansi	NN
dorong	NN
dosa	NN
dosen	NN
dosis	NN
doyan	NNS
doyong	JJ
draf	NN
drainase	NN
dramatik	JJ
dramatis	JJ
dramatisasi	NN
dramaturg	NN
dramawan	NN
draperi	NN
drastis	JJ
dresur	NNS
drif	NN
dril	NN
dropsi	NNS
drumer	NN
dua	CD
duaja	NN
dualisme	NN
dubes	NN
dubius	JJ
duble	RB
dubuk	NN
dubur	NN
duda	NN
duduk	NN
dudur	DT
dudus	NN
duga	NN
dugang	RBR
duha	NN
duhe	MD
duhu	NN
duit	NN
duk	NN
duka	NN
dukacita	NN
dukana	NN
dukaten	NN
duktulus	NN
duktus	NNS
dukuh	NN
dukun	NN
dukung	NN
dulag	NN
dulang	NN
duli	NN
dulur	NN
dung	NN
dungas	PRP
dungkul	IN
dungu	NN
dunia	NN
duniawi	RB
duodesimal	NN
dup	IN
dupa	IN
dupleks	NN
duplik	NN
duplikasi	NN
duplikat	NN
duplikator	NN
duplo	RB
dur	JJ
durasi	NN
durat	VBN
duren	JJ
dureng	NN
durhaka	NN
duri	JJ
durjana	NN
durkarsa	PRP$
durma	NN
duru	NNS
dus	RB
dusin	NN
dusta	NN
dustur	NN
dusun	NN
duta	NNS
duwet	NN
duyung	NN
dwibahasa	JJ
dwidasawarsa	NN
dwiminggu	NN
dwipurwa	NN
dwitunggal	NN
dwiwarna	JJ
eban	PRP
ebek	NNS
ecek	RB
edafologi	NNS
edan	NN
edisi	NN
edukasi	NN
edukatif	JJ
efedrina	NN
efek	NN
efektif	JJ
efektivitas	NN
efektor	NN
efendi	NN
efisien	NN
efisiensi	NN
efloresensi	NN
efusi	NN
egah	JJ
egalitarisme	NN
egaliter	JJ
egois	NN
egoisme	NN
egoistis	NN
egol	JJ
egosentris	NN
egosentrisme	NN
egrang	NNS
ehe	NN
eigendom	NN
eja	VB
ejakulasi	NN
ejan	PRP
ejek	VBN
ekabahasa	PRP
ekabahasawan	NNS
ekaristi	NN
ekbalium	NN
ekderon	NN
ekeh	NN
ekimosis	NN
eklektik	JJ
eklektikus	JJ
eklips	NN
ekliptika	JJ
ekliptis	JJ
eklosi	NN
ekoklimatologi	NN
ekokronologi	NNS
ekolabel	NN
ekolalia	NN
ekologi	NN
ekologis	JJ
ekon	NNS
ekonom	NN
ekonometri	NNS
ekonomi	NN
ekonomis	JJ
ekopolitik	JJ
ekopraksia	NN
ekor	NN
ekornia	NN
ekosistem	NN
ekosistematika	NNS
ekoturisme	NN
ekrin	NN
ekrinologi	NN
eks	NN
eksak	NN
eksakta	NN
eksaltasi	VBN
eksamen	NN
eksaminasi	NN
eksaminator	NN
eksantem	NN
eksekusi	NN
eksekutif	NN
eksekutor	NN
eksem	NN
eksemplar	NN
eksentrik	JJ
eksepsi	NN
ekses	NNS
eksesif	JJ
ekshalasi	NN
ekshibisi	NN
ekshibisionis	NNS
ekshibisionisme	NNS
ekshibitum	NN
eksikator	NN
eksin	NN
eksipien	NN
eksisi	NN
eksistensi	NN
eksistensialisme	NN
eksitasi	NN
eksitus	NN
ekskavasi	NN
ekskavator	NN
eksklave	VB
eksklusif	JJ
ekskomunikasi	NN
ekskresi	NN
ekskreta	NN
ekskursi	NN
eksobiologi	NN
eksodus	NN
eksoenzim	NNS
eksofasia	NN
eksofora	VBN
eksoftalmia	NN
eksoftalmos	NN
eksoftalmus	NN
eksogen	JJ
eksogin	NN
eksoisogami	NN
eksordium	NN
eksorsis	NNS
eksospora	NNS
eksostosis	NNS
eksotermik	JJ
eksotik	JJ
eksotis	JJ
eksotisme	NN
ekspansi	NN
ekspansif	JJ
ekspansionisme	NN
ekspatriasi	NN
ekspatriat	NNS
ekspedisi	NN
ekspeditor	VBG
ekspektoran	NN
eksper	NN
eksperimen	NN
eksperimental	NN
ekspirasi	NN
eksplikasi	NN
eksplisit	NN
eksploit	NN
eksploitasi	NN
eksploitir	NNS
eksplorasi	NN
eksploratif	JJ
eksplorator	NN
eksplosif	JJ
eksponen	NN
eksponensial	JJ
ekspor	NN
eksportir	NN
ekspos	VB
ekspose	NN
eksposisi	NN
ekspres	NN
ekspresi	NN
ekspresif	JJ
ekspresivitas	JJ
ekstase	NN
ekstasi	NN
ekstensi	NN
ekstensif	JJ
ekstensifikasi	NN
ekstensor	NN
eksterior	NN
ekstern	JJ
eksternal	JJ
ekstra	JJ
ekstradisi	NN
ekstrak	NN
ekstrakardial	NN
ekstraksi	NN
ekstraktif	JJ
ekstrakurikuler	NN
ekstrapolasi	NN
ekstraseluler	NN
ekstraterestrial	JJ
ekstrauterin	NN
ekstrem	NN
ekstremis	NN
ekstremitas	NNS
ekstrinsik	JJ
ekstrospeksi	NN
ekstrusi	NN
eksudasi	NN
eksudat	NN
ektoblas	PRP
ektoderm	NN
ektohormon	NN
ektoplasma	NN
ektoterm	NN
ektotermik	JJ
ekualitas	NN
ekuatif	NN
ekuator	DT
ekuilibrium	NN
ekuinoks	NN
ekuitas	NN
ekuiti	NN
ekuivalen	NN
ekumene	NN
ekumenis	JJ
ekumenisme	PRP
ela	PRP
elaborasi	NN
elak	NN
elan	NN
elang	NN
elastik	NN
elastis	JJ
elastisitas	NN
elefantiasis	NN
elegan	NN
elegi	NN
elektif	JJ
elektret	NN
elektrifikasi	NN
elektrik	NN
elektris	JJ
elektro	NN
elektrode	NN
elektrodinamika	NNS
elektroforesis	NN
elektrokardiogram	NN
elektrokimia	NN
elektrokoagulasi	NN
elektrolisis	NN
elektrolit	NN
elektromagnet	NN
elektromagnetik	JJ
elektromagnetisme	NN
elektromiografi	NN
elektron	JJ
elektronik	JJ
elektronika	NNS
elektronis	JJ
elektroskop	NN
elektrostatika	NNS
elektroteknik	JJ
elektroterapi	NN
elektrum	JJ
elemen	NN
elementer	NNS
elemi	JJ
eleng	RB
elevasi	NN
eliksir	NN
eliminasi	NN
eling	VB
elips	NN
elipsis	NN
elipsometri	NN
elo	NN
elok	JJ
elpiji	NN
elu	NN
eluat	NN
elung	NN
elus	JJ
elusif	JJ
emansipasi	NN
emaskulasi	RB
emat	VB
embah	NN
embalase	NN
embalau	VBG
emban	NN
embara	VBN
embarau	NN
embarkasi	NN
embek	NN
embel	NN
ember	NN
embik	NN
embol	NN
embolisme	NN
embrio	NN
embriogenesis	NN
embriologi	NNS
embrionik	NN
embuai	VBG
embuh	NN
embun	NN
embut	NNS
emfisema	NN
emigran	PRP
emigrasi	NN
emir	NN
emirat	NN
emis	VBN
emisi	NN
emiten	NN
emol	RB
emolumen	NN
emosi	NN
emosional	JJ
emosionalisme	NN
emotif	JJ
empang	NNS
empap	NN
empat	CD
empati	NN
empedu	NN
empenak	NNS
empeng	NN
emper	RB
empiema	DT
empiris	JJ
empirisme	NN
empoh	NN
empok	NN
empos	NN
emprak	NN
empu	NN
empuk	JJ
empulur	NN
empunya	NN
emrat	NNS
emulasi	NN
emulsi	NN
en	IN
enak	NN
enam	DT
enau	PRP$
encang	NN
encek	NN
encer	NN
encik	NN
encim	NN
encit	NN
encok	NN
endal	JJ
endemi	JJ
endemis	JJ
endilau	NN
endogen	JJ
endokardia	NN
endokrin	NN
endokrinologi	NN
endolimfa	VBN
endomiokarditis	NN
endong	NN
endorfin	NNS
endosentris	NN
endoskop	NN
endoskopi	NN
endosperma	NN
endotermal	NN
endul	NN
enek	VBN
energetik	JJ
energi	NN
energik	JJ
enfitotik	IN
engah	NN
enggak	DT
enggan	NN
enggang	NN
enggil	NN
engkah	NN
engkak	RB
engkang	PRP
engkau	NN
engkoh	NN
engkol	NN
engkong	VBG
engku	NN
engsel	NN
enjambemen	NN
enjin	NN
enkapsulasi	NN
enklave	NNS
enkripsi	NN
enkulturasi	NN
enologi	NNS
ensambel	JJ
ensefalitis	NN
ensefalitogen	NN
ensefalograf	NN
ensefalografi	NN
ensefalogram	NN
ensefalomielitis	NN
ensefalon	NN
ensiklik	JJ
ensiklopedia	DT
ensiklopedis	NN
entah	DT
entak	NN
entalpi	NN
entar	RB
ente	NN
enten	DT
enteng	RB
entente	NN
enterograf	NN
entit	NN
entitas	NN
entomologi	NN
entong	VB
entozoa	NN
entozoik	NN
entre	IN
entri	NNS
entropi	NN
envoi	NN
enyah	NN
enyak	NN
enzim	NN
enzimolisis	NN
enzimologi	NN
eolit	NN
eosen	NN
eozoikum	NN
epak	NN
epidemi	JJ
epidemiologi	NN
epidiaskop	NN
epifiotik	IN
epifisis	NN
epifit	NNS
epifora	NN
epigrafi	NN
epik	NN
epikuris	PRP
epilepsi	NN
epileptik	JJ
epilog	NN
epinefrina	NN
episentrum	NN
episiklik	NN
episiotomi	NN
episkopal	NN
episkopat	NN
epistel	NN
epistemologi	NN
epistola	NN
epitaksi	NNS
epitel	NN
epitelioma	NN
epitet	NN
epok	NNS
epoksi	NN
epolet	NN
eponim	NN
epos	NN
erak	NN
eram	VBD
erang	NN
erat	VBD
ereh	NN
ereksi	NN
erektor	NN
erepsin	PRP
eret	VBZ
erg	RB
ergonomi	NNS
ergonomika	NNS
ergonomis	JJ
ergoterapi	JJ
erisipelas	JJ
eritema	NN
eritroblas	NNS
eritrosit	NNS
erong	RB
eror	NN
erosi	VB
erot	NNS
erotik	JJ
erotika	NN
erotis	JJ
erotisisme	NN
erotisme	NN
erti	NN
eru	VBP
erupsi	NN
es	VBZ
esa	IN
esai	NN
esak	RB
esek	DT
eselon	NN
esensi	NN
esensial	JJ
esensialitas	NN
eskader	NN
eskalasi	NN
eskalator	NN
eskapisme	NN
eskas	JJ
eskatologis	JJ
esofagus	NN
esok	NN
esot	VBG
esoteris	NN
estafet	NN
estesia	NN
estetik	JJ
estetika	NNS
estetis	JJ
estimasi	NN
estron	NN
estuari	JJ
eta	CC
etalase	NN
etanol	NN
etape	NNS
etek	NN
eteris	NN
eternit	NN
etik	JJ
etika	NNS
etiket	NN
etil	NN
etimologi	NN
etimologis	RB
etimon	NN
etiologi	NN
etis	JJ
etnik	JJ
etnis	NN
etnobotani	NN
etnograf	NN
etnografi	NN
etnolinguistik	NN
etnolog	NN
etnologi	NN
etnomusikolog	NN
etnomusikologi	NNS
etnopolitik	JJ
etnosentrisme	NN
etologi	NN
etsa	IN
eudaemonisme	NN
eufemisme	NN
eufemistis	JJ
eufoni	NN
euforia	NN
euforian	JJ
eukaliptus	NN
eukariota	NNS
eulogi	NNS
eurosentris	NN
euseksual	NN
eutanasia	NN
eutektik	IN
evakuasi	NN
evaluasi	NN
evaluatif	JJ
evangeli	NNS
evangelis	NNS
evaporasi	NN
eviden	NNS
eviserasi	NN
evokasi	NN
evolusi	NN
evolusioner	JJ
evolusionisme	NN
eyang	NN
eyel	NN
faal	JJ
faali	JJ
fabula	JJ
faden	NN
faedah	NN
fahombe	NN
fajar	NN
fakir	JJ
faks	NN
faksi	NN
faksimile	NN
fakta	NN
faktor	NN
faktual	JJ
faktur	NNS
fakultas	NN
fakultatif	JJ
falak	NNS
falsafah	NN
famili	NN
familia	NN
familier	NNS
familisme	NN
fana	NN
fanatik	JJ
fanatisme	NN
fani	NNS
fantasi	NN
fantastis	JJ
fantom	NN
farak	NN
faringalisasi	NN
faringitis	NN
farmakodinamika	NN
farmakokinetika	NNS
farmakolog	NN
farmakologi	NN
farmakologis	RB
farmakope	NN
farmakoseutika	NNS
farmasi	NN
fase	NN
faset	VBD
fasia	VBN
fasih	NN
fasik	NN
fasilitator	NN
fasis	NN
fasisme	NN
fatala	NN
fatalisme	NN
fatamorgana	NN
fatur	PRP
faunistik	JJ
favorit	NN
favoritisme	NN
februari	JJ
federalisme	NN
federasi	NN
fekunditas	NN
feminin	NN
feminisme	NN
fenol	NN
fenomena	NN
fenomenal	NN
fenomenologi	NN
fenotipe	NN
feodal	NN
feodalisme	NN
feodalistis	JJ
feri	NN
feritin	NN
fermentasi	NN
feromagnetik	JJ
feromagnetisme	JJ
feromon	NN
feronikel	NN
fertilisasi	NN
fertilitas	NN
feses	NNS
fetis	NN
fi	VB
fiasko	NN
fibrasi	NNS
fibriblas	NNS
fibrilasi	NN
fibrokistik	JJ
fidusia	JJ
figur	NN
figuran	VB
figuratif	JJ
fiil	NN
fikih	NN
fiksasi	NN
fiksi	NN
fiktif	JJ
fikus	MD
filamen	NN
filantrop	NN
filantropi	NN
filantropis	NN
filateli	RB
filatelik	NN
filatelis	NN
filial	NN
filmis	IN
filo	NN
filologis	NN
filosofi	NN
filosofis	JJ
filsafat	NN
filsuf	NN
filtrasi	NN
filtrat	VBN
filum	NN
finansial	JJ
finir	NN
finis	VBN
firasat	NN
firdaus	NN
firma	NN
firman	NN
fisi	NN
fisik	JJ
fisika	NNS
fisikawan	NN
fisiologi	NN
fisiologis	JJ
fisioterapi	NN
fisis	NNS
fiskal	JJ
fitnah	NN
fitofag	NN
fitogeni	NN
fitogeografi	NN
fitokimia	NNS
fiton	NN
fitopatologi	NNS
fitososiologi	NN
fitosterol	NN
fitotoksin	NN
fitotopografi	NN
fitotron	NN
flakon	NN
flamboyan	NN
flanel	NNS
flegma	JJ
fleksi	NN
fleksibel	JJ
fleksibilitas	NN
fleksor	NN
flensa	NN
flis	NN
flotasi	NN
fluida	NN
fluks	NN
fluktuasi	NNS
fluktuatif	NN
fluoresen	NN
fluoresens	NN
fluorin	NN
fobia	NN
fokus	NN
foli	NN
folikel	NNS
folklor	NN
fonasi	NN
fondasi	NN
fonem	NN
fonetik	JJ
fonetis	NNS
fonograf	NN
fonografi	DT
fonologi	NN
fonologis	NN
fonon	NN
fonotipi	NN
forensik	NNS
formalitas	NN
formasi	NN
formatif	JJ
formatur	NNS
formika	JJ
formulasi	NN
formulir	NN
forsir	NNS
forte	JJ
fortifikasi	NN
fosfat	NN
fosfina	NN
fosfor	NN
fosforesens	NN
fosforilase	VBN
fosforus	NN
fosil	NN
foto	NN
fotodiode	NN
fotogenik	NN
fotograf	NN
fotografer	NN
fotografi	NN
fotografis	JJ
fotokimia	NN
fotokonduksi	NN
fotokonduktivitas	NN
fotokopi	NN
fotometer	NN
fotometri	NNS
fotomodel	NN
foton	NNS
fotoperiodisme	NN
fotosfer	NN
fotosintesis	NN
fotostat	NN
foya	NN
fragmen	NN
fragmentasi	NN
fraksi	NN
fraksinasi	NN
fraktur	NN
fransium	NN
frasa	NN
fraseologi	NNS
fregat	NN
frekuen	NN
frekuensi	NN
frenologi	NN
friksi	NN
fruktosa	NN
frustrasi	NN
fugasitas	NN
fukaha	NN
fukara	DT
fulgurit	NNS
fuli	NN
fulus	NN
fumigasi	NN
fundamentalis	NN
fundamentalisme	NN
fungisida	NN
fungsional	JJ
fungsionalisasi	NN
fungsionalisme	NN
fungsionalitas	NN
fungsionaris	NNS
furnitur	NN
fusi	NN
fusta	NN
fusuk	NNS
futur	NN
futurisme	NN
futuristik	JJ
futuristis	JJ
futurologi	NNS
gabah	NN
gabir	NN
gablek	NNS
gabro	NN
gabuk	NN
gabung	NN
gabus	NN
gacok	NN
gada	NN
gadai	NN
gadamala	NN
gading	NN
gadis	NN
gado	NNS
gaduh	NN
gaduk	VBG
gadungan	NN
gaet	NN
gagah	NN
gagak	NN
gagal	VBD
gagang	NNS
gagap	NN
gagas	NN
gagau	NN
gaguk	NN
gaham	NN
gai	NN
gaib	JJ
gairah	NN
gajah	NN
gaji	NN
gajih	NN
gajul	NN
galaba	NN
galah	NN
galai	DT
galak	NN
galaksi	NN
galaktometer	NN
galaktosa	NN
galaktosemia	NN
galar	NN
galat	NN
galau	NN
galeri	NN
gali	MD
galias	DT
galiot	IN
galir	NN
galium	NN
galon	NN
galuh	JJ
galur	NN
galvanis	VBN
galvanisasi	VBG
galyas	NN
gama	NN
gaman	NN
gamang	NN
gambar	NN
gambas	NNS
gambir	NN
gamblang	JJ
gambuh	NN
gambut	NN
gamet	NN
gamis	NN
gamit	NN
gampang	JJ
gamparan	NN
gamping	NN
gamuh	NN
gana	NN
ganang	PRP
ganar	NN
ganas	NN
gancang	NN
gancu	NN
gandar	NN
gandarukem	RB
gandarusa	NN
gandasturi	NN
gandeng	VBN
gandes	NN
gandewa	NN
gandok	NN
gandul	NN
gandum	NN
ganggang	NN
ganggu	NN
gugat	JJ
ganggut	NN
gangsa	NN
gangsar	NNS
gangsi	NN
gani	WP
ganih	NN
ganjal	NN
ganjil	NN
ganjing	VBG
gantal	NN
gantang	NN
ganteng	NN
ganti	VB
ganting	NN
gantung	VBG
gaok	NN
gapai	NN
gapit	RB
gaplek	VBN
gaplok	NN
gapura	NN
gar	IN
garai	NN
garam	NN
garangan	NN
garansi	NN
garap	NN
garasi	NN
gardan	NN
gardu	NN
garebek	NN
gari	NN
garindin	NN
garing	NN
garis	NN
garmen	NN
garnis	VBN
garnisun	NN
garpu	NN
garu	NN
garuk	NN
garut	NN
garwa	NN
gasak	NN
gasang	JJ
gasifikasi	NN
gastroenterologi	NN
gastronomi	NN
gatal	NN
gatuk	NNS
gauk	VB
gaukang	NN
gaun	NN
gaung	NN
gaut	VBN
gawan	NN
gawang	NN
gawar	NN
gawat	JJ
gaya	NN
gayang	IN
gayau	NN
gayeng	NNS
gayuh	RB
gayuk	JJ
gayun	RB
gayung	NN
gaz	NN
gebar	VBD
geber	NN
geblok	VBN
gebos	DT
gebot	NN
gebu	NN
gebuk	NN
gecek	TO
gecer	NN
gedabah	NN
gedebeg	NN
gedek	VBN
gedembai	NN
gedeng	NN
gedi	NN
gedik	NN
gedok	NN
gedombak	NN
gedubang	NN
gedung	NN
gegabah	NN
gegadan	IN
gegai	NN
gegak	DT
gempita	NN
gegaman	NN
gegap	NN
gegar	NN
gegares	NNS
gegas	NN
gegat	JJ
gegep	NNS
geger	NN
gegua	NN
gejala	NNS
gejolak	NN
gela	DT
gelabah	JJ
gelabir	NN
gelabur	VBG
geladak	NN
geladrah	NN
gelagap	NN
gelagar	NN
gelagat	NN
gelak	NN
gelakak	NNS
gelam	NN
gelambir	NN
gelandang	NN
gelang	VBN
gelanggang	NN
gelangsar	NN
gelanting	VBG
gelap	NN
gelapung	NN
gelar	NN
gelas	NN
gelasir	NN
gelatuk	NN
gelayar	MD
geleca	DT
geledah	NN
geledang	NNS
geledek	NN
geleding	NN
gelegak	NN
gelegar	NN
gelek	DT
gelekak	JJ
gelekek	VBN
gelemberan	VBG
gelembong	JJ
gelembung	JJ
gelembur	NN
gelempang	JJ
gelemprang	JJ
gelenang	NN
gelendong	NN
geleng	NN
gelenting	NN
gelenyar	NN
gelepar	NN
gelepot	NN
gelepur	NN
geler	NN
gelesot	NN
geleta	NN
geletak	JJ
geletar	NN
geletek	VBG
geletis	NN
geli	VBN
geliang	NN
geliat	VBN
gelibir	NN
geligi	NNS
gelimang	DT
gelimantang	VBG
gelimir	NN
gelimpang	NN
gelimun	NN
gelincir	NN
gelinding	VBG
gelintar	NN
gelintin	VB
gelintir	VBN
gelipar	VB
gelisah	JJ
gelita	RB
gelitar	NN
gelo	NN
gelombang	NN
gelondong	NNS
gelongsor	NN
gelora	NN
geloso	JJ
gelotak	NNS
geluduk	NN
gelugur	NN
geluh	NN
geluk	NN
gelumat	NN
geluncur	NN
gelung	NN
gelut	NNS
gema	NN
gemak	NN
gemar	NN
gemas	NNS
gemawan	NN
gembak	JJ
gembala	NN
gembel	JJ
gembeng	NN
gembira	JJ
gembleng	JJ
gemblong	NN
gemblung	JJ
gembok	NN
gembong	NN
gembos	VBN
gembreng	JJ
gembul	PRP
gembung	VBN
gembur	JJ
gembut	NN
gemeletak	NNS
gemercik	NN
gemerlap	VBG
gemertak	NN
gemertuk	NN
gemetar	VBG
gemi	NN
gemik	VBN
gemilang	JJ
gemilap	NN
geming	VBG
geminte	VBD
gemirang	NN
gempa	NN
gempal	NN
gempar	NN
gempur	NN
gemuk	NN
gemul	NN
gemulai	NN
gemuruh	JJ
genah	RB
genang	NN
genap	RB
gencar	NN
gencer	JJ
gencir	NN
gendak	NN
gendang	NN
gendar	NN
genderang	NN
gendewa	NN
gendis	NN
gendong	VBG
genduk	VB
gendut	NN
genealogi	NN
genealogis	NNS
generalisasi	NN
generalisimo	VBN
generasi	NN
generatif	NN
generik	NN
genetika	NNS
genetis	RB
geng	NN
genggam	NN
genggang	NN
gengsi	NN
genialitas	JJ
genikulum	NN
genit	NN
genjang	NN
genjik	NN
genom	IN
genosida	NN
genotipe	NN
genta	NN
gentala	NN
gentar	JJ
gentas	NN
gentat	NN
gentayang	NN
gentel	NN
genteng	NN
gentong	NN
gentur	NN
gentus	NNS
geodesi	NN
geofisika	NNS
geofisikawan	NN
geofisis	JJ
geografi	NN
geografis	JJ
geohidrologi	NN
geokimia	NN
geolog	NN
geologi	NN
geologis	JJ
geometri	NN
geometris	NN
geomorfologi	NN
geopolitik	NNS
geostasioner	JJ
geoteknik	JJ
geoteknologi	NN
geotermal	NN
gepeng	JJ
geplak	VBN
gepok	NN
gepuk	JJ
gera	VB
gerabah	NN
gerabang	NN
geraguk	NN
gerah	RB
geraham	NN
gerai	NN
gerak	NN
geram	PRP
geramus	RB
gerang	NN
gerangan	IN
geranggang	NN
gerat	NN
geratih	NN
gerawan	NN
gerayah	DT
gerayang	NN
gerbang	NN
gerbong	NNS
gerbus	NN
gerdan	VB
gerecak	MD
gerecok	JJ
gereja	NN
gerejani	JJ
gerejawi	JJ
gerek	NN
geremet	NN
gerempang	RB
gerendel	NN
gerendeng	NN
gereneng	NN
gerenik	NN
gerenyeng	NN
gerenyet	JJ
geresek	NN
geret	VBG
geretak	NN
gergaji	NN
gergasi	NN
gergeran	DT
gerhana	NN
geriak	NNS
geriatrik	NNS
gerigi	NN
gerih	JJ
gerilya	NN
gerilyawan	NNS
gerim	VB
gerimis	NN
gerinda	NNS
gering	JJ
gerinyau	DT
gerip	NN
geripir	NN
geripis	NN
gerit	NNS
gerlap	NN
germo	NN
gero	RB
geroak	RB
gerobak	NN
gerohok	NN
gerombong	NN
geronggang	NN
gerontologi	NN
geros	JJ
gersang	NN
gersik	NN
gertak	VBG
gertik	IN
gertuk	RB
geru	NN
geruit	VBN
gerumuk	NN
gerumut	NN
gerun	NN
gerung	NN
gerunggung	NN
gerunyam	NN
gerup	VBN
gerus	IN
gerutu	JJ
gesa	NN
gesek	NN
gesel	NNS
geser	VBG
gesit	IN
gesper	NN
geta	MD
getah	NN
getap	NNS
getar	NNS
getas	NN
getek	NN
getik	NNS
getir	NN
getok	VBG
getu	NN
gewang	NN
giam	NN
giat	JJ
gibang	VBG
gidik	NN
gigantisme	NN
gigi	NN
gigih	NN
gigis	NN
gigit	NN
gilang	NN
gilap	VBN
gilas	NN
giling	NN
gilir	NN
gimnasium	NN
gimnastik	NNS
gimpal	NN
ginang	NN
gincu	NN
ginding	NN
ginekolog	NN
ginekologi	NN
ginglimus	NN
ginjal	NN
gips	NN
gipsi	NN
gir	VBZ
girang	VBN
giras	NNS
girasol	NN
giri	NNS
girikan	NN
giring	NN
giris	NN
giro	NN
giroskop	NN
girostatika	JJ
gisik	NN
gitar	NN
gitaris	NN
giur	NN
giwang	VBG
gizi	NN
glasial	JJ
glasir	NN
glaukoma	NN
glegek	NN
gletser	NN
glidik	NN
glikogen	NN
glikol	NN
glikolisis	NN
glikosida	NNS
glikosidase	NN
glikosuria	NNS
gliserol	NN
globalisasi	NN
globalisme	NN
glosarium	JJ
glosem	NN
glosematik	NN
glotalisasi	NN
glotis	NN
glukagon	NN
glukosa	NN
glukosan	NN
glukosida	NN
goak	NNS
goba	NN
goblok	JJ
goda	JJ
godak	NN
gohok	NN
gojlok	JJ
gol	NN
golak	NNS
golek	NN
golok	NN
gombak	NN
gombal	NNS
gombang	NN
gombeng	VBG
gombrang	NN
gondok	NNS
gondol	NN
gondong	NNS
gondrong	JJ
gong	NN
gonggo	NN
gonggok	NN
gonggong	NN
gongli	NN
gongseng	NN
goni	NN
gonjang	NN
gonjok	NN
gonokokus	NN
gonore	NN
gontai	JJ
gonyel	NN
gopoh	NN
gorden	NNS
goreng	VBN
gori	NN
gorila	NN
gorilya	NN
goroh	NN
gosip	NN
gosok	NN
gosong	NN
gotes	NNS
gotik	JJ
gotrok	JJ
gotun	VBD
goyah	VBG
goyang	VBG
grabadan	NN
grad	NN
gradasi	NN
gradien	NN
grafem	NN
grafetik	JJ
grafik	JJ
grafika	NNS
grafis	JJ
grafit	NN
grafitasi	NN
gramatika	NN
gramofon	NN
granat	NN
granit	NN
granulasi	NN
grasi	NN
gratifikasi	NN
gratis	JJ
graver	VB
gravitasi	NN
gregarius	DT
gres	NN
grogi	JJ
gros	JJ
grosir	NN
grup	NN
gu	NN
gua	NN
guanidina	NN
guanina	NN
gubang	NN
gubernur	NN
gubit	VBG
gubuk	NN
guci	NNS
gudang	NN
gudi	NN
gue	NN
gugah	NN
guguh	NN
guguk	TO
gugup	JJ
gugur	NN
gugus	NN
gujirat	NN
gulai	NN
gulali	NN
gulam	NN
gulana	NN
gulat	NN
guli	NN
guliga	TO
guling	NNS
gulir	NN
gulita	NN
gulma	NNS
gulud	NN
gulung	NN
guma	NN
gumam	VBN
gumba	NN
gumpal	NN
guncang	NN
gunci	NN
gundah	RB
gundang	NN
gundi	NN
gundik	DT
gunduk	NN
gundul	NN
gunggung	JJ
guntang	NN
gunting	NN
guntur	NN
gunung	NN
gurab	RB
gurami	NN
gurat	NNS
gurau	NN
gurdan	IN
guri	NN
gurih	NN
gurit	NN
gurita	NN
guruh	NN
gurun	NN
gurur	NN
gusah	NN
gusar	JJ
gusel	NN
gusi	NN
gusti	NNS
gusul	NN
gusur	VBN
gutasi	NN
gutik	JJ
ha	PRP
habenula	VBN
habis	IN
habitus	NN
hablur	NN
habuan	NN
habuk	NN
hadap	IN
hadas	NNS
hadat	NN
hadiah	NN
hadir	NN
hadirat	NN
hadirin	NNS
hadis	NN
hahnium	NN
haid	NN
hajat	NN
haji	NN
hak	NN
hakikat	NN
hakiki	JJ
hakul	VB
hal	NN
hala	RB
halalbihalal	NN
halaman	NN
halang	NN
halau	NN
halba	JJ
haleluya	NN
halia	NN
halilintar	VBG
halimun	NN
halimunan	NN
halofili	NN
halsduk	NN
halte	NN
haluan	NN
halus	NN
halusinasi	NNS
hamatum	NN
hamba	NN
hambar	NN
hambat	NN
hambur	VBG
hamil	NN
hampa	NN
hampir	RB
hancur	NN
lebur	VBG
luluh	NN
handai	NN
handelar	NN
handuk	NN
hangat	NN
hanggar	NN
hantam	NN
hantar	NN
hantu	NN
hanya	RB
hanyut	VBG
hap	NN
haplologi	NNS
hapus	NN
harakah	VB
harakat	NN
harap	NN
harbi	NN
harfiah	RB
harga	NN
hari	NN
harimau	NN
harini	NN
harisah	NN
harmoni	NN
harmonik	NN
harmonika	NN
harmonis	JJ
harmonisasi	NN
harpa	NN
harpun	NN
harta	NN
hartawan	NN
haru	NN
haruan	NN
harum	NN
harus	MD
hasan	NN
hasar	NN
hasil	NNS
hasrat	NN
hasta	IN
hasut	VB
hati	NN
hatta	RB
haud	RB
haukalah	NN
haur	NN
hawa	NN
hayat	NN
hayati	NN
hayo	IN
heban	NN
hebat	JJ
heboh	VBN
hebras	NNS
hebring	NN
hedonisme	NN
hegemoni	NN
heksadesimal	NN
heksagon	NN
heksaklorida	NN
heksameter	NN
heksana	NN
hektar	NN
hektare	NNS
hektograf	NN
hektometer	NN
hela	JJ
helah	NN
helai	NNS
helikopter	NN
heling	VBG
helmintologi	NN
hem	PRP
hemat	NN
hematit	NN
hematologi	NN
hematom	NN
hemodialisis	NN
hemofilia	NN
hemolisis	NN
hemoragi	NN
hemoroid	NNS
hendak	NN
hendel	NN
heng	NN
hengit	JJ
hengkang	VB
hening	NN
hentar	NNS
henti	NN
heptana	NN
heraldik	NN
heran	NN
herba	NN
herbisida	NN
herbivora	NN
hereditas	DT
herediter	NN
heregistrasi	NN
heresi	NN
hermafroditisme	NN
heroik	NN
heroisme	NN
herpetolog	NN
herpetologi	NN
heterofil	JJ
heterogen	JJ
heterogenitas	NN
heteroseksual	JJ
heterotrof	NN
hewan	NN
hewani	NN
hias	NN
hibah	NN
hibat	VBG
hibernasi	NN
hibrida	NN
hibridis	NNS
hibridisasi	NN
hibur	NN
hidang	NN
hidayah	NN
hidrasi	NN
hidrat	NN
hidraulika	NNS
hidraulis	NNS
hidrida	NN
hidrodinamika	NNS
hidrofili	NN
hidrofit	NN
hidrofobia	NN
hidrofon	NN
hidrogen	NN
hidrogenasi	NN
hidrogeologi	NN
hidrografi	NN
hidrogram	NN
hidrokarbon	NNS
hidroklorida	NN
hidrokori	NN
hidroksida	NN
hidroksil	NN
hidrolisis	NN
hidrologi	NN
hidrometeorologi	NN
hidrometer	NN
hidrometri	NN
hidronan	NN
hidroponik	NNS
hidrosfer	RB
hidrostatika	NNS
hidrostatis	NN
hidroterapi	NN
hidrotermal	NN
hidung	RB
hidup	NN
hiena	NN
hierarki	NN
hierarkis	JJ
hifa	NN
higiene	NN
higienis	NN
higrometer	NN
higrometri	NN
higroskop	NN
higroskopis	NN
hijau	JJ
hikayat	NN
hikmah	NN
hikmat	NN
hilal	NN
hilang	VBN
hilau	NN
hilir	NN
himanga	NN
himen	NNS
himne	NN
himpun	NN
hindar	NN
hinduisme	NN
hingga	TO
hinggap	VBN
hiosiamina	TO
hiperaktif	NN
hiperamnesi	NN
hiperbarik	NN
hiperbol	NN
hiperbolis	NN
hiperemia	NN
hiperestesia	NN
hipergami	NN
hiperkelas	NNS
hiperkinesis	NN
hiperkorek	NNS
hiperkritis	NN
hiperlipemia	NN
hipermetropia	NN
hiperparasit	NN
hiperplasia	NN
hiperseksual	JJ
hipersensitif	NN
hipersonika	NN
hipertensi	NN
hipertonik	NN
hipertradisional	NN
hipertrikosis	NN
hipertrofi	NN
hipervitaminosis	NN
hipnosis	NN
hipnoterapi	NN
hipnotis	JJ
hipnotisme	NN
hipoblas	NNS
hipofisis	JJ
hipogen	NN
hipoglikemia	NN
hipokrisi	NN
hipokrit	NN
hipokritis	NN
hipomastia	NN
hiponim	NN
hipopituitarisme	NN
hipoplankton	NN
hipoplasia	NN
hipopotamus	NN
hipotaksis	RB
hipotek	NN
hipotensi	NN
hipotenusa	NN
hipotermia	NN
hipotesis	NN
hipotetis	RB
hipotiroid	NN
hipotiroidisme	NN
hipotonik	NN
hipui	NN
hiruk	NN
hirup	JJ
histamina	NN
histerektomi	NN
histeria	NN
histeris	JJ
histerisis	NN
histidina	NN
histokimia	NN
histologi	NN
histopatologi	NN
histori	NN
historikus	NN
historiografi	NN
historis	JJ
putih	JJ
hitung	NN
hiu	NN
hobi	NN
hodadoda	IN
hoki	RB
holisme	NN
holozoik	NN
homofon	NN
homofoni	NNS
homogen	RB
homogeni	JJ
homogenitas	NN
homologi	NN
homonim	NN
homonimi	NN
homoseks	NNS
homoseksual	JJ
homoseksualisme	NN
homoseksualitas	NN
homozigot	NN
honae	JJ
honorer	NN
hopbiro	NN
horas	NNS
hore	RB
hormat	NN
hormon	NN
horor	NN
horoskop	NN
hortikultura	NN
hortikulturis	JJ
hostes	DT
hosti	DT
huakiau	NN
hububan	DT
hubung	NN
hudai	PRP
hujah	NN
hujan	NN
hujat	NN
huji	NN
hujung	NN
hukum	NN
hulam	NN
huler	NNS
hulubalang	NN
huma	VBP
humaniora	NNS
humanis	TO
humanisme	NN
humanitas	NNS
humaniter	RB
humas	NN
humiditas	NN
humoris	JJ
hun	PRP$
huni	JJ
hurah	JJ
huria	JJ
hurikan	NN
huruf	NN
hus	NN
hutan	NN
huyung	JJ
ia	PRP
ialah	VBZ
iambus	NN
iba	RB
ibadah	NN
iban	VBD
ibarat	IN
ibidem	NN
iblis	DT
ibrit	NN
ibu	NN
ibunda	NN
ida	NN
idam	NN
idas	IN
ide	RB
idealis	NN
idealisasi	NN
idealisme	NN
idem	DT
identifikasi	NN
identik	JJ
identitas	NN
ideofon	NN
ideologi	NN
ideologis	JJ
idiil	NN
idiomatis	NN
idiosi	NN
idola	NN
idrak	NN
idu	PRP
iduladha	NN
iga	NN
igal	DT
igau	PRP
ih	PRP
ihsan	NN
ihtimal	NNS
ihwal	IN
ijab	NN
ijas	NN
ijazah	NN
ijon	NN
ijuk	NNS
ikal	RB
ikamah	NN
ikan	NN
ikat	NN
ikhlas	RB
ikhtiar	NN
ikhtisar	NN
iklan	NN
iklim	NN
ikon	NN
ikonografi	NN
ikonometer	NN
ikram	NN
ikrar	NN
iktibar	NN
iktikad	NN
iktiraf	VB
iktisab	NN
ikut	VB
serta	CC
ilahi	NN
ilat	NN
ilegal	JJ
iler	IN
iles	PRP
iling	NN
ilmiah	JJ
ilmu	NN
ilmuwan	NNS
ilu	NN
iluminasi	NN
ilusi	NN
ilusionis	NNS
ilustrasi	NN
imago	NN
imaji	NNS
imajinasi	NN
imajinatif	JJ
imajiner	JJ
imam	NN
imani	NN
imbak	NN
imbang	NN
imbas	NN
imbau	VBD
imbit	NN
imigran	NN
imigrasi	NN
imitasi	NN
imitatif	JJ
imkan	NN
imla	VBG
imlek	NN
imobilisasi	NN
impak	NN
impas	NN
impase	NN
impedans	NN
impedansi	NN
impek	NNS
imperatif	NN
imperialis	NN
imperialisme	NN
impi	NN
implan	NNS
implantasi	NN
implementasi	NN
implikasi	NNS
implisit	NN
impor	NN
importasi	NN
importir	NN
impoten	NN
impotensi	NN
impregnasi	NN
impresariat	NN
impresi	NN
impresif	JJ
impresionis	NN
improvisasi	NN
impuls	NN
impulsif	JJ
imtihan	NN
imun	NN
imunisasi	NN
imunitas	NN
imunokompromi	NNS
imunologi	NN
imunologis	NN
imunosupresi	NN
imunoterapi	NN
absensia	NN
ina	IN
inang	NN
inap	NN
inaugurasi	NN
inci	NN
incit	NN
incrit	NN
indah	NN
indayang	JJ
indebitum	JJ
indekos	NN
indeks	NN
inden	IN
independen	JJ
indik	VBD
indikan	NN
indikasi	NN
indikatif	JJ
indikator	NN
indisipliner	NN
individu	JJ
individualis	NN
individualisme	NN
individualistis	JJ
individualitas	NN
indoktrinasi	NN
indologi	NNS
indonesianisasi	NN
indriawi	NN
induk	NN
induksi	NN
induktans	NN
induktansi	NN
induktif	JJ
induktor	NN
industri	NN
industrialis	NN
industrialisasi	NN
industriawan	NN
inefisiensi	NN
inersia	NN
infanteri	NN
infantil	NN
infarktus	NN
infeksi	NN
inferensi	NN
infertil	NN
infertilitas	NN
infiks	NN
infiltrasi	NN
infinitif	JJ
inflamasi	NN
inflasi	NN
infleksif	JJ
influensa	NN
informan	PRP
informasi	NN
informatif	JJ
informatika	NNS
inframerah	VBN
infrastruktur	NN
infus	NN
inga	DT
ingar	NN
ingat	VB
ingau	NN
inggris	JJ
ingin	NN
ingkah	NN
ingkar	NN
ingkir	VB
inheren	NN
inhibisi	NN
ini	DT
inisial	NNS
inisiasi	NN
inisiatif	NN
inisiator	NN
injak	VBG
injap	NN
injeksi	NN
injil	DT
inkarnasi	NN
inkarserasi	VBG
inkaso	NN
inklaring	NN
inklusif	JJ
inkompatibilitas	NN
inkomplet	NN
inkonsisten	NN
inkonsistensi	NN
inkonstitusional	JJ
inkonvensional	JJ
inkremental	NN
inkubasi	NN
inkubator	NN
inokulasi	NN
inovasi	NN
inovatif	JJ
inovator	NN
insaf	TO
insan	NN
insang	NN
insani	NN
insek	NN
insekta	NN
insektisida	NN
inseminasi	NN
insentif	NN
insersi	NN
inses	VBN
insiden	NN
insidental	NN
insinerator	NN
insinyur	NN
inskripsi	NN
insolven	NN
inspeksi	NN
inspektorat	NN
inspektur	NN
inspirasi	NN
instabilitas	NN
instalasi	NN
instalatur	NN
instan	NN
instansi	NN
insting	NN
institusi	NN
institusional	JJ
institut	NN
instruksi	NNS
instruksional	JJ
instruktur	NN
instrumen	NN
instrumentalis	DT
instrumentasi	NN
insya	NN
allah	NN
intai	RB
intan	NN
integrasi	NN
integritas	NN
intelek	JJ
intelektual	JJ
inteligen	NN
inteligensi	NN
inteligensia	NN
intelijen	NN
intens	JJ
intensi	NN
intensif	JJ
intensifikasi	NN
intensitas	NN
interaksi	NN
interaktif	JJ
interdepartemental	NN
interdisipliner	JJ
interes	NN
interesan	PRP
interferens	NN
interferensi	NN
interjeksi	NN
interkoneksi	NN
interkontinental	NN
interlokal	RB
internalisasi	NN
internasional	JJ
internasionalisasi	NN
internat	NN
internir	TO
internis	NNS
interogasi	NN
interogator	NN
interpelasi	NN
interpolasi	NN
interpretasi	NN
interpretatif	JJ
intersepsi	NN
interupsi	NNS
intervensi	NN
interviu	NN
inti	PRP
intim	NN
intimasi	NN
intimidasi	NN
intip	NN
intipati	DT
intoleran	NN
intonasi	NN
intransitif	JJ
intraseluler	NN
intravena	RB
intrik	NN
intrinsik	JJ
introduksi	NN
introspeksi	NN
intrusi	NNS
intuisi	NN
intuitif	JJ
invasi	NN
invensi	NN
inventaris	NN
inventarisasi	NN
inventif	JJ
inventori	NN
inversi	NN
invertebrata	NNS
investasi	NN
investigasi	NN
investigatif	JJ
invitasi	NN
invois	NN
inziaj	NN
iodin	NN
ionisasi	NN
ionosfer	RB
ipar	NN
ipis	NN
ipuk	NN
iradiasi	NN
iram	NN
irama	NN
irasional	JJ
irasionalitas	NN
iri	VB
irigasi	NN
irigator	NN
irik	NN
irit	JJ
iritasi	NN
ironi	NN
ironis	NN
irsyad	NN
irung	RB
isak	NN
isap	NN
isbat	NN
iseng	NN
isi	PRP$
isim	NN
isit	RB
iskemia	NN
islah	NN
islamis	NN
islamisasi	NN
islamisme	NN
isodin	NN
isofet	NN
isogon	NN
isohiet	NN
isokemi	NNS
isokeraunik	NN
isokronisme	NN
isolasi	NN
isolasionisme	NN
isoleks	JJ
isometrik	NN
isoriza	VB
isosilabisme	NN
isoterm	NN
isotop	NN
israf	NN
istal	NNS
istana	NN
istidlal	VBG
istikmal	NN
istilah	NN
istima	NN
istimewa	JJ
istimna	JJ
istimtak	NNS
istiqlal	NN
istirahat	NN
istisna	NN
istri	NN
isu	NNS
isya	NNS
isyarat	NN
isyu	NN
italik	NN
iterasi	NN
itibak	NN
itik	NN
itil	NN
itrium	NN
itu	IN
iya	NNS
izah	NN
izin	NN
jaat	PRP
jabat	NN
tangan	NN
jadam	NN
jadi	RB
jaduk	NN
jadwal	NN
jaga	NN
jagabaya	JJ
jagal	NN
jagat	DT
jagawana	NNS
jagung	NN
jaha	NN
jahanam	NN
jaharu	NN
jahat	NN
jahe	NN
jahil	NN
jahit	VBG
jainisme	NN
jais	IN
jaja	NN
jajah	NN
jajak	NN
jajan	NN
jajar	NN
jaka	WP
jakas	DT
jaket	NN
jaksa	TO
jaksi	NN
jakun	VB
jala	NN
jalad	NNS
jalak	VBG
jalan	NN
jalang	NN
jalin	NN
jalu	NN
jalur	NN
jamak	JJ
jambak	VBN
jamban	NN
jambar	NN
jambat	VB
jambe	NN
jambon	NN
jambore	NN
jambret	NN
jambu	NN
jamin	NN
jampal	NN
jampi	NN
jamu	NN
jamur	NNS
janat	NN
janda	NN
jangak	NN
jangan	VB
jangar	NN
janggal	NN
janggelan	JJ
janggung	NN
janggut	NN
jangka	NN
jangkah	NN
jangkang	NN
jangkar	NN
jangkau	NN
jangki	NN
jangking	VBG
jangkir	NN
jangkit	NNS
jangkrik	NNS
jangkung	NN
jani	PRP$
janin	NN
janjang	RB
janji	NN
jantan	NN
jantang	NN
jantina	NN
jantuk	NN
jantung	NN
jantur	NNS
januari	NN
janubi	NN
japin	VBG
jarah	NN
jarak	NN
jarang	RB
laut	VBG
jaras	NN
jarem	NN
jari	NN
jaring	NNS
jaro	NN
jarum	NN
jas	PRP
jasa	NNS
jasad	NN
jasadi	DT
jasmani	JJ
jasmaniah	JJ
jatah	NN
jati	NN
jatuh	NN
jauh	RB
jauhar	NN
jauhari	NN
jauza	NN
jawab	NN
jawang	NN
jawawut	NN
jawer	NN
jaz	PRP
jazirah	NN
je	PRP
jebai	NN
jebak	NN
jebar	VB
jeblok	NN
jeblos	VB
jebol	JJ
jejabah	NN
jejak	NNS
jejaka	NNS
jejas	NN
jejer	NNS
jela	NN
jelaga	NN
jelah	NN
jelai	NN
jelajah	NN
jelak	NN
jelalat	NN
jelang	RB
jelapang	RB
jelas	JJ
jelata	NN
jelatang	NN
jelek	RB
jeli	VBZ
jelimet	JJ
jelit	JJ
jelita	NNS
jelu	NN
jelujur	NN
jeluk	NN
jelum	NN
jelus	NN
jelut	NN
jemaat	NN
jemah	RB
jemala	VBD
jemari	NNS
jemawa	JJ
jembak	NN
jembalang	NN
jembar	JJ
jembatan	NN
jembel	JJ
jembut	NN
jempol	NN
jempul	JJ
jemput	NN
jemu	PRP
jemuas	NN
jemuju	NN
jemur	VBG
jenahar	NN
jenak	NN
jenaka	NN
jenama	NN
jenat	VBN
jenazah	NN
jendel	DT
jendela	NN
jendera	NN
jenderal	JJ
jendol	VBD
jendul	NN
jeneng	NN
jenewer	NN
jengang	NN
jengger	NN
jenggot	NN
jenggul	NN
jenggut	NN
jengkal	NN
jengkel	JJ
jengker	NN
jengket	NN
jengking	NN
jengkit	NN
jengkolet	VBG
jenguk	NN
jenis	NN
jenius	NN
jenjam	VBG
jenjang	NN
jentaka	JJR
jentang	NN
jentera	NN
jentik	NN
jenuh	VBN
jepet	VBN
jepit	NNS
jepret	NN
jepun	JJ
jeput	NN
jera	NN
jerait	NN
jeram	NNS
jerami	NN
jerang	NN
jerangkong	NN
jerapah	NN
jerat	NNS
jeraus	RB
jerawat	NN
jeremba	NN
jerepet	NN
jeriau	NN
jerigen	NN
jerih	NN
jeriji	NN
jeriken	NN
jeringing	VBG
jerit	NN
jernih	JJ
jeroan	NNS
jerubung	VBG
jeruji	NNS
jeruju	RB
jeruk	NN
jerum	NN
jerumat	NN
jerumbai	NN
jerumun	NN
jerung	NNS
jerungkau	NN
ji	NN
jiawang	NN
jicing	NN
jidar	NN
jidat	NN
jigong	NN
jih	PRP
jihat	NN
jijik	VBN
jijit	NN
jika	IN
jikalau	IN
jilat	NN
jilbab	NN
jilid	NN
jimat	VB
jin	NN
jinak	RB
jinem	RB
jineng	NN
jingau	NN
jingga	NN
jingkat	NN
jingkik	NNS
jingkrak	VBG
jingu	NN
jinjing	JJ
jinjit	NN
jip	NN
jiplak	NN
jir	JJ
jiran	NN
jirat	NN
jisim	NN
jitu	VBG
jiwit	NN
jobak	NNS
jodoh	NN
jogar	NN
joget	NN
joging	NN
jok	NN
joki	NNS
jolak	NN
joli	RB
jompak	NN
jompo	NN
jonget	JJ
jonggol	NN
jongko	NN
jongkok	NN
jorok	NN
jota	WP
jotang	NN
jotos	NN
jua	RB
juadah	NN
jual	NN
juandang	NN
juang	NN
juara	NN
jubah	NN
jubel	NN
jubin	NN
judul	NN
juga	RB
juih	VBN
jujah	NN
jujai	IN
jujuh	NN
jujur	NN
jujuran	NN
jujut	NN
jukut	NN
julang	NN
julat	NN
juli	NN
juling	NN
julir	NN
juluk	NN
jumadilakhir	JJ
jumat	NN
jumbai	NN
jumbuh	RB
jumeneng	NN
jumlah	NN
jumpa	VB
jumpalit	PRP
jumpelang	NN
jumpul	JJ
jumput	NN
jungat	NNS
jungkal	NN
jungkat	NN
jungkir	NN
jungkit	NNS
jungut	NN
juni	NN
juntrung	RB
juragan	NN
jurai	NN
jurang	NN
juri	NN
juring	NN
jurnal	NN
jurnalis	NN
jurnalisme	NN
jurnalistik	NN
juru	NN
juruh	NN
justifikasi	NN
justru	RB
juta	CD
jutawan	NN
juvenil	NN
juz	RB
kaba	NN
kabak	NN
kabar	NN
kabaret	NN
kabel	JJ
kabihat	TO
kabilah	NN
kabin	NN
kabisat	NN
kabit	NN
kabul	NN
kabumbu	VBG
kabupaten	NN
kabur	VBN
kabus	NN
kabut	NN
kaca	NN
kacak	NN
kacamata	NNS
kacang	NNS
kacapiring	NN
kacapuri	NN
kacau	JJ
kacek	VBN
kacici	NN
kacuk	NN
kacukan	NN
kacung	NN
kad	WRB
kada	WRB
kadal	NN
kadang	RB
kadar	IN
kadas	WP
kadaster	NN
kadastral	JJ
kadaver	NN
kade	NN
kader	NN
kadera	NNS
kaderisasi	NN
kades	NN
kadet	NN
kadi	NN
kadim	NNS
kadipaten	NN
kadir	NN
kadmium	NN
kado	NN
kadru	NNS
kadung	NN
kadut	DT
kaedah	NN
kaf	VBN
kafaah	NN
kafan	NN
kafeina	NN
kafetaria	NNS
kafil	NN
kafilah	NN
kafir	NN
kafiri	DT
kagak	RB
kaget	VBN
kagok	NN
kagum	VBN
kah	NN
kahak	NN
kahin	NN
kahyangan	NN
kaidah	NN
kail	NN
kailalo	JJ
kain	NN
kainit	NN
kainofobia	NN
kais	NN
kaisar	NN
kait	NN
kajangan	NN
kaji	NN
kakak	NN
kakanda	NN
kakao	NN
kakap	NN
kakas	NN
kakek	NN
kaki	NNS
kakodil	NN
kakofoni	NN
kakok	NN
kaksa	WP
kaktus	NN
kakus	NN
kala	NN
kalah	VB
kalajengking	NN
kalakati	NN
kalakian	NN
kalamin	DT
kalamkari	NN
kalander	NN
kalap	NN
kalas	NN
kalat	NNS
kalau	IN
kalaupun	RB
kalaza	JJ
kalbi	NN
kalbu	NN
kaldron	NN
kaldu	NN
kalebas	NN
kaleidoskop	NN
kalem	VB
kalender	NN
kaleng	NNS
kalian	PRP
kaliber	NN
kalibrasi	NN
kalifornium	NN
kaligraf	NN
kaligrafi	NN
kaligrafis	NN
kalih	CD
kaliki	NN
kalimah	NN
kalimantang	NN
kalimat	NN
kalimatullah	NN
kalimatusyahadat	NN
kalimpanang	NN
kalingan	NN
kalio	NN
kaliper	NNS
kalipso	NN
kalis	NN
kalium	NN
kalk	NN
kalkarium	NN
kalkosium	NN
kalkulasi	NN
kalkulator	NN
kalkulus	NN
kalkun	NN
kalo	NN
kalomel	NN
kalong	NN
kalor	NN
kalori	NNS
kalorimeter	NN
kalorimetri	NN
kalorisitas	NN
kalowatan	NNS
kalsiferol	NN
kalsifikasi	NN
kalsinasi	NN
kalsit	NN
kalsium	NN
kalui	NN
kalung	NN
kalus	NN
kalut	VBD
kam	VBD
kama	IN
kamantuhu	NN
kamar	NN
kamat	NN
kamba	NN
kamban	NN
kambi	NN
kambing	NN
kambium	NN
kambrik	NN
kambrium	NN
kambuh	NN
kamera	NN
kamerad	NN
kamerawan	NN
kamfer	NN
kamhar	NN
kami	PRP
kamis	NN
kamit	PRP
kamitua	NN
kamka	NN
kamomil	NN
kamp	NN
kampa	NN
kampai	NNS
kampanologi	NN
kampanye	NN
kampas	NN
kampemen	NN
kamper	NNS
kamping	VBG
kampiun	NNS
kampret	NNS
kampuh	NN
kampung	NN
kampus	NN
kamsia	NN
kamuflase	NN
kamus	JJ
kan	MD
kanaah	NN
kanabis	NN
kanal	NNS
kanalisasi	NN
kanan	NN
kanang	NN
kancah	DT
kancera	NN
kancil	NN
kancing	NNS
kanda	NN
kandang	NN
kandar	NN
kandas	VB
kandela	NN
kandidat	NN
kandidiasis	NN
kandil	NN
kandis	NN
kandung	NN
kandut	NN
kang	PRP
kangar	NN
kangen	NN
kangkung	NN
kangsa	NNS
kanguru	NN
kanibal	NN
kanibalisasi	NN
kanibalisme	NN
kanilem	NN
kanina	RB
kanjang	VB
kanker	NN
kanoman	NN
kanonis	NN
kanopi	NN
kans	NN
kansel	NN
kanselir	NN
kanser	NN
kanstof	NN
kanta	NN
kantang	DT
kantata	NNS
kanti	VBD
kantilever	NN
kantin	NN
kanto	NN
kantong	NN
kantor	NN
kantuk	NN
kantung	NN
kanun	NN
kanvas	NN
kanya	PRP
kanyon	NN
kaon	DT
kaos	NNS
kap	VBZ
kapa	NN
kapabel	JJ
kapai	NNS
kapak	NN
kapal	NN
kapan	WRB
kapang	NN
kaparinyo	NN
kapas	NN
kapasitans	NN
kapasitas	NN
kapasitor	NN
kapat	RB
kapel	NN
kapela	NN
kapi	DT
kapilaritas	NN
kapiler	NN
kapis	IN
kapita	NN
kapital	NN
kapitalis	NN
kapitalisme	NN
kapitulasi	NN
kaplok	NNS
kapok	NN
kapon	NN
kaporit	NN
kapsalon	NN
kapsel	NN
kapstan	NN
kapster	NN
kapstok	NN
kapsul	NN
kapten	NN
kapu	NN
kapuk	NNS
kapung	NN
sirih	NN
kara	NN
karabin	NN
karambol	NN
karamel	NN
karang	JJ
karantina	NN
karantinawan	NN
karar	NN
karavan	NN
karbida	NNS
karbohidrase	NN
karbohidrat	NN
karboksil	NN
karbol	NN
karbolat	NN
karbolik	NN
karbon	NN
karbonan	NN
karbonat	NN
karbonil	NN
karbonisasi	NN
karborundum	NN
karburasi	VBG
karburator	NN
karcis	NN
kardia	NN
kardiak	NN
kardigan	NN
kardil	IN
kardinal	NN
kardiograf	NN
kardiografi	NN
kardiogram	NN
kardiolog	NN
kardiologi	NN
kardiovaskular	NN
karditis	NN
kardus	NN
karembong	NN
karena	IN
karet	NN
kargo	NN
karib	NN
karibu	RB
karier	NN
karies	NNS
karikatur	NN
karikatural	NNS
karikaturis	NNS
karinasi	NN
karismatik	JJ
karkas	NN
karkata	JJ
karnaval	NN
karnivor	JJ
karoseri	NNS
karotena	NN
karotenoid	NNS
karotis	NN
karper	NN
karpet	NN
karpopodil	NN
karsa	NN
karsinogen	NNS
karsinogenik	NN
karsinoma	NN
karti	NN
kartilago	NN
kartografi	NNS
kartogram	NN
karton	NN
kartotek	NN
kartu	NN
merah	JJ
kartun	NN
kartunis	NN
karu	NN
karuhun	NN
karun	DT
karung	NN
karunia	NNS
karusi	NNS
karut	NN
karya	NN
karyawan	NNS
karyawati	NN
karyawisata	NN
kas	WP
kasa	JJ
kasai	NN
kasar	NN
kasasi	NN
kasau	NN
kasein	NN
kasemat	VB
kasep	RB
kaserin	NN
kaserol	NN
kaset	NNS
kasid	NN
kasih	NN
kasihan	NN
kasino	NN
kasip	VBG
kasir	NN
kasiterit	NN
kaskaya	DT
kasmir	RB
kasregister	NN
kasta	NN
kasti	TO
kastroli	NN
kasturi	NN
kasual	JJ
kasualisme	NN
kasualitas	NN
kasuari	NN
kasuis	VBD
kasuistik	JJ
kasur	NN
kasus	NN
kasut	NNS
kata	NNS
katabolisme	NN
katadrom	NN
katafora	NN
katah	JJ
katak	NN
katakana	VB
katalase	NN
katalepsi	NN
katalina	NN
katalis	NN
katalisator	NN
katalisis	NN
katalogisasi	VBG
katamaran	NN
katapel	NN
katarak	NN
katarsis	NN
katartik	NN
katastrofe	NN
katawi	VBN
katebelece	NN
katedral	JJ
kategori	NN
kategoris	JJ
kategorisasi	NN
katekis	NN
katekismus	NN
katel	NN
katelum	NN
kater	NN
katering	NN
kateter	NN
katetometer	DT
kati	NN
katib	NN
katibin	PRP$
katik	RB
katil	NN
kation	NN
katode	NN
katolik	NN
katrol	NN
katul	NN
katun	NN
katup	NN
katut	CC
kau	PRP
kaukab	NN
kaukasoid	NN
kaukus	NN
kauli	NN
kaum	RB
kaupui	NN
kaus	NN
kausa	DT
kausal	NN
kausalitas	NN
kausatif	NN
kaut	NN
kavaleri	NN
kaviar	NN
kawah	NN
kawal	NN
kawan	NN
kawasan	NN
kawat	NN
kawi	NN
kawih	JJ
kawin	JJ
kawula	PRP
kaya	JJ
kayan	VBG
kayang	MD
kayau	VBG
kayu	NN
kebal	NN
kebam	NNS
kebas	NN
kebat	NN
kebayan	NN
kebelet	VB
kebembem	NN
kebiri	NN
kebuk	NN
kebul	NNS
kebun	NN
kebut	VBG
kecai	NN
pinggang	NN
kecam	NNS
kecambah	NNS
kecamuk	VBN
kecap	NN
kecapi	NN
kecar	VBD
kece	NN
kecebong	NN
keceng	NN
kecewa	JJ
keci	NN
kecibak	NN
kecibeling	NN
kecik	JJ
kecil	JJ
kecimik	NN
kecimpung	NN
kecimus	NN
kecipak	NNS
kecipir	NN
kecipuk	NN
keciut	NN
kecoak	NNS
kecombrang	VBN
kecong	NN
kecuali	IN
kecubung	NN
kecut	NN
kedadak	NNS
kedah	MD
kedai	NN
kedal	NNS
kedaluwarsa	VBD
kedam	NN
kedangkai	NN
kedangkan	VBG
kedangsa	VBG
kedap	JJ
kedasih	NN
kedau	RB
kedebong	NN
kedek	VBN
kedekut	NN
kedelai	NN
kedele	NN
kedempung	NN
kedengkang	VBG
keder	VBN
kedera	VBN
kedewaga	NN
kedi	NN
kedip	NN
kedok	NN
kedongkok	NN
kedot	NN
keduduk	NN
keduk	NN
kedul	RB
kedumung	NN
kedut	NNS
kejam	NN
kejamas	VBZ
kejang	NNS
kejap	JJ
kejar	NN
kejat	PRP
kejer	NN
keji	NN
kejip	JJ
keju	NN
kejuju	NN
kejur	NN
kejut	NN
kek	NN
kekal	JJ
kekam	NN
kekang	NN
kekar	NN
kekas	JJ
kekat	NN
kekawin	JJ
kekebik	NN
kekek	NN
kekel	NN
kekep	VBN
kekitir	NN
kekok	NN
kelab	NN
kelabak	NN
kelabang	NN
kelabat	NNS
kelabau	NN
kelabu	NN
keladak	NN
keladan	NN
keladi	MD
kelahi	NN
kelai	NN
kelak	RB
kelakah	NN
kelakanji	NN
kelakar	NN
kelalang	NN
kelam	NN
kelambir	NN
kelambit	JJ
kelambu	NN
kelamin	NN
kelangkan	NN
kelangkang	NN
kelanjar	NN
kelantang	NN
kelapa	NN
kelar	VBN
kelarah	NN
kelarai	NN
kelas	NN
kelasa	TO
kelasah	NN
kelasak	VB
kelasi	JJ
kelat	NNS
kelati	NNS
kelawan	RB
kelayan	RB
kelayang	NN
kelayu	NN
kelder	NN
kelebek	NN
kelebet	NN
kelebu	IN
kelebuk	NNS
kelebut	NN
keledai	NN
keledang	NN
keledar	NN
keledek	NN
kelejat	VB
kelek	NN
kelekap	NN
kelekatu	NN
kelelap	NN
kelelawar	NN
kelelesa	NN
kelelot	NNS
kelemayuh	NN
kelembak	NN
kelemping	NN
kelemur	NN
keleneng	DT
kelengkeng	NN
kelenjar	NN
kelentang	NNS
kelenteng	NN
kelentit	NN
kelentung	NN
kelenyit	JJ
kelep	NN
kelepak	NN
kelepat	NN
kelepek	NN
kelepet	NN
kelepir	NN
kelereng	NNS
kelesa	NN
kelesah	NN
peseh	NN
kelesek	NN
kelesot	NN
keletah	NN
keletak	DT
keletang	VBG
keletik	NN
keletuk	DT
keletung	DT
keli	DT
kelian	NN
kelibang	NN
kelibat	NN
kelicap	NN
kelik	RB
kelikat	NN
keliki	VB
kelikik	NN
kelikir	NN
keliling	IN
kelilip	VBG
kelimpanan	NN
kelimpungan	VBN
kelimun	NN
kelimut	DT
kelinci	NN
kelincir	NN
kelingking	NN
kelingsir	DT
kelining	PRP$
kelinjat	NNS
kelintang	VBG
kelip	NN
kelipat	NN
kelir	NN
keliru	JJ
kelisera	NN
kelit	NN
kelitik	NNS
kelok	NN
kelokak	NN
kelola	NN
kelolong	NN
kelom	NN
kelompang	NN
kelompen	NN
kelompok	NN
kelong	NN
kelongkong	NN
kelongsong	VBG
kelontong	NN
kelopak	NNS
kelos	NN
kelosok	NN
keloyang	NN
keloyor	NN
keluai	NN
keluar	NN
keluarga	NN
kelubak	NN
keluburan	DT
keluh	VBN
kelui	VBG
keluk	NN
kelukup	RB
kelukur	DT
keluli	NN
kelulu	NN
kelulus	VBN
kelulut	NNS
kelumit	NN
kelumun	JJ
kelun	NN
keluna	NN
kelunak	NN
kelung	NN
kelupas	NN
kelupur	NN
kelurut	NN
kelus	NNS
kelut	NN
keluyuk	IN
keluyur	VBG
kemah	NN
kemal	NN
kemamang	NNS
kemangi	NN
kemarau	NN
kemari	VB
kemarin	NN
kemaruk	NN
kemas	NN
kembal	RB
kembali	RB
kembang	NNS
kembar	NN
kembol	NN
kembuk	NN
kembung	VBN
kembut	NN
kemeja	NN
kemejan	NN
kemekmek	TO
kemelut	NN
kemenakan	NN
kemendalam	NN
kemendang	DT
kemendur	NN
kemenyan	NN
kemerakan	NN
kemi	PRP
kemih	NN
kemik	NN
kemilap	NN
kemiluminesens	NN
kemiri	NN
kemlaka	NN
kemoceng	NN
kemopsikiatri	NN
kemoterapi	NN
kempal	NN
kempek	NNS
kempu	NN
kempuh	NN
kempunan	NN
kemu	NN
kemudi	VBG
kemudian	RB
kemukus	NN
kemul	NN
kemumu	NN
kemuncup	NN
kemungkus	NN
kemuning	NN
kemunting	VBG
kemut	NN
kemutul	NN
kena	TO
kenal	VB
kenang	NNS
kenap	VB
kenapa	WRB
kenari	NN
kenas	JJ
kencan	NN
kencang	NN
kenceng	NN
kencing	NN
kencung	VBN
kendala	NNS
kendali	NN
kendana	NN
kendang	NNS
kendati	IN
kendayakan	NN
kendeka	VB
kendi	JJ
kendit	NN
kenduduk	NNS
kendung	NN
kendur	NN
kenduri	NN
keneker	RB
kenem	NN
keng	JJ
kengkang	NN
kenikir	NN
kening	NN
kenohong	NN
kenop	NN
kental	NN
kentang	NN
kentar	NN
kentara	NN
kenteng	NN
kentut	NN
kenyal	NN
kenyam	NN
kenyang	JJ
kenyat	JJ
kenyut	NN
keok	NN
keong	NNS
kep	NNS
kepada	TO
kepai	NN
kepak	NN
kepal	NN
kepala	NN
kepalang	NN
kepam	NN
kepang	NN
kepar	NN
keparat	NN
kepayang	NN
kepencong	NN
keper	NN
kepet	NN
kepetang	NN
kepialu	NN
kepik	NN
kepil	NN
kepincut	VBD
kepinding	NN
keping	NNS
kepingin	NN
kepinis	NN
kepinjal	NN
kepiri	JJ
kepis	NN
kepit	NNS
kepiting	NN
keplok	NN
keponakan	NN
kepot	VBN
keprak	NN
kepret	NN
kepruk	NN
kepuh	NN
kepuk	NN
kepulaga	NN
kepundan	NN
kepundung	NN
kepung	VBD
kepurun	NN
kepuyuk	NN
kera	IN
kerabang	NNS
kerabat	NNS
keracak	VBN
kerah	NN
kerajang	NN
kerajat	NN
kerak	NN
keramas	NN
keramat	VBN
kerambil	NN
keramik	NNS
keramikus	NN
keran	NN
kerancang	NN
keranda	NN
kerang	NNS
kerangkai	NN
kerangkeng	NN
kerani	NN
keranjang	NN
keranjat	NN
kerap	RB
kerapu	NN
keras	JJ
kerasan	IN
kerat	NN
keratabasa	NN
keraton	NN
kerawat	NN
kerbau	NN
kerbuk	NN
kerdak	VBG
kerdil	NN
kere	NNS
keredak	NN
kerek	NN
kereket	NN
kerekut	NN
kerempeng	NN
keren	NN
kerencung	NN
kereneng	NN
kereng	PRP
kerengga	NNS
kerengkam	NN
kerentang	NNS
kerepek	NNS
kerepes	NN
kerepot	NN
kerese	NNS
pese	NN
keresek	VBG
keresot	NNS
kereta	NN
keretan	NN
keretek	NNS
keriap	DT
kericau	NN
keridas	NN
keridik	NN
kerikil	NN
kerikit	JJ
kerimut	DT
kerinding	NN
kering	NN
keringat	NN
keriningan	PRP
kerinjal	NN
kerinjing	NN
kerintil	NN
kerinting	RB
keripik	NNS
keriput	NNS
keris	NN
kerising	NN
keritik	VBG
keriting	RB
kerja	NN
kerjantara	NN
kerjap	NN
kerkap	NN
kerlap	NN
kerlip	VBG
kermak	NN
kernai	NN
kernu	NN
kernyau	NN
kero	NN
kerobak	NNS
kerobat	NNS
kerocok	NN
kerok	NN
kerokot	NN
keroncang	NN
kerong	NN
kerongsang	NNS
kerontang	VBN
kerop	NN
keropak	NNS
keropeng	NN
keropok	NNS
keropos	JJ
kerosak	NN
kerosok	NN
kerosong	NNS
kerot	NNS
kerotak	NN
kerotot	NN
keroyok	NN
kers	NN
kersen	NNS
kersik	NN
kersuk	NN
kertaaji	NNS
kertak	NN
kertas	NN
kertuk	NN
kertus	NN
keruan	NN
kerubin	NN
kerucil	NN
kerucut	NN
kerudung	NN
keruh	NN
keruit	NN
keruk	NN
kerukut	VBN
kerul	JJ
keruma	NN
kerumit	NN
kerumuk	DT
kerumun	NN
kerumus	DT
kerung	CC
kerunting	VBN
keruntung	NN
kerunyut	NN
kerupuk	NNS
kerut	NN
keruyuk	NN
kes	WP
kesak	NN
kesal	NN
kesam	NN
kesambet	NN
kesambi	NN
kesan	NNS
kesang	VBN
kesatria	NN
kesek	CD
keseleo	NN
kesemek	NN
keseran	NNS
keseser	NNS
keset	IN
kesi	NN
kesiap	JJ
kesik	NN
kesima	TO
kesip	NN
keskul	IN
kesongo	NN
kesrakat	NN
kesturi	NN
kesumat	NN
kesumba	NN
kesup	NN
kesusu	NN
keta	DT
ketam	NN
ketambak	NN
ketan	NN
ketang	NN
ketap	NNS
ketapak	NN
ketar	JJ
ketat	NN
ketaya	NN
ketayap	DT
ketegar	NN
ketel	NN
ketela	NN
ketemu	NN
ketena	NN
ketepeng	NN
ketes	NN
keti	NN
ketiak	NN
ketial	JJ
ketiap	JJ
ketiau	NN
ketik	NN
ketika	WRB
ketilang	VB
ketimbul	NN
keting	VBG
ketinjau	NN
ketirah	NN
ketis	VBG
ketok	NN
ketombe	NN
ketonggeng	NN
ketosa	NN
ketrek	NN
ketu	RB
ketua	NN
ketuat	NNS
ketuban	JJ
ketuir	CD
ketuk	NN
ketumbar	NN
ketumbu	NNS
ketumpang	NN
ketun	NN
ketur	VBZ
ketus	NN
keweni	NNS
kewer	NN
kewes	NN
khalayak	NNS
khamir	NN
khas	JJ
khasiat	NN
khatulistiwa	NN
khawatir	JJ
khazanah	NNS
khi	WRB
khianat	JJ
khidmat	NN
khilaf	NN
khitan	NN
khotbah	NN
khurafat	NN
khusus	JJ
kial	WRB
kiam	WRB
kiamat	NN
kiambang	DT
kian	RBR
kiap	NN
kiar	NN
kiasi	NN
kiat	NNS
kiaupau	NN
kibar	NN
kibir	NN
kiblat	NN
kiblik	NN
kibul	NN
kicau	VBG
kici	PRP
kicu	NN
kicuh	PRP
kidal	NN
kidang	NN
kidul	NN
kidung	NN
kijang	NN
kijing	NN
kik	WP
kikil	NN
kikir	NN
kikuk	NN
kila	DT
kilang	NN
kilap	NN
kilar	NNS
kilas	NN
kilat	NN
kilau	NN
kili	NN
kilokalori	NNS
kiloliter	NNS
kilus	IN
kimantu	RB
kimia	NN
kimiawi	NN
kimograf	NN
kimpal	NN
kimpus	NN
kina	NN
kinang	NN
kinasa	NN
kinasih	VBN
kinca	NNS
kincak	NN
kincang	VBG
kincir	NN
kincup	NN
kinematika	NNS
kinerja	NN
kineskop	NN
kinetik	NNS
kinetika	NNS
kini	RB
kintal	NN
kinyang	NN
kio	WP
kios	NN
kipas	NN
kiper	NN
kiprah	NN
kipsiau	NN
kipu	NN
kir	VBN
kira	NN
kirab	NN
kirap	NN
kiri	NN
kirik	DT
kirim	NN
kirip	NN
kirita	NN
kirmizi	JJ
kirung	NN
kisa	NN
kisah	NN
kisar	NN
kisat	NNS
kisi	NN
kisik	NN
kismis	NNS
kisruh	JJ
kista	NN
kisut	NNS
kita	PRP
kitab	NN
kitang	PRP
kitar	NN
kitin	NN
kiu	WP
kiuk	NN
kiwari	RB
kizib	NN
klaim	NN
klakson	NN
klamidospora	NNS
klangenan	PRP
klante	NNS
klarifikasi	NN
klarinet	NN
klasemen	NNS
klasifikasi	NN
klasik	JJ
klasikal	JJ
klasis	NN
klasisisme	NN
klausa	NN
klaustrofobia	NN
klaustrum	NNS
klausul	NN
klaver	NN
klavikula	NN
kleder	NN
klem	NN
klemensi	NN
klen	JJ
klengkeng	JJ
klenik	NN
klenteng	NN
klep	NN
kleptofobi	NN
kleptomaniak	NN
klerikal	NN
klerus	NN
klien	NN
klik	NN
kliker	NN
klimaks	NN
klimakterium	NN
klimatolog	NN
klimatologi	NN
klinik	NN
klinis	JJ
klinisi	NN
klip	NN
kliring	NN
klise	NNS
klitelum	NN
klitik	NN
klitoris	NN
kloaka	NN
klona	NN
kloning	VBG
klonus	NNS
klop	NN
kloramina	NN
klorat	NN
klorida	NN
kloridimeter	NN
klorin	NN
klorinasi	NN
klorit	NN
klorobenzena	NN
klorofil	NN
kloroform	NN
kloroformat	NN
kloroplas	NNS
kloroprena	NN
kloset	NN
klub	NN
knalpot	NN
knop	NN
koa	RB
koagregasi	NN
koagulan	NN
koagulasi	NN
koaksi	NN
koaksial	NN
koalisi	NN
koana	DT
kobak	NNS
kobalt	NN
koboi	NN
kobok	NNS
kobra	NN
kocak	JJ
kocek	NN
kocoh	NN
kocok	NN
kocong	NN
koda	NN
kode	NN
kodein	NN
kodeks	NN
kodi	NN
kodifikasi	NN
kodok	NN
kodrat	NN
kodrati	JJ
koefisien	NN
koeksistensi	NN
koenzim	NNS
koersi	NN
koersif	NN
kognatif	NN
kognisi	NN
kognitif	NN
kohabitasi	NN
koheren	NN
koherensi	NN
kohesi	NN
kohesif	NN
kohir	DT
kohlea	NN
kohor	NN
koil	NN
koin	NN
koit	NN
koja	WDT
kojor	NNS
kok	RB
koka	NN
kokaina	NN
kokainisasi	NN
kokainisme	NN
kokarde	NN
kokas	NNS
koki	WP
koklea	NN
kokoa	DT
kokok	NN
kokosan	NN
kokot	NN
kokpit	NN
koksa	NN
koktail	NN
kokus	NNS
kol	IN
kolaborasi	NN
kolaborator	NN
kolagen	NN
kolak	NN
kolam	NN
kolaps	NN
kolase	NN
kolateral	NN
kolator	NN
kolega	NN
kolegial	NN
kolegialitas	NN
kolek	NN
koleksi	NN
kolekte	NN
kolektif	NN
kolektivis	NN
kolektivisasi	NN
kolektivisme	NN
kolektivitas	NN
kolektor	NN
kolembeng	IN
kolera	NN
kolese	DT
kolesom	NN
kolesterin	NN
kolesterol	NN
kolibri	NN
koligasi	TO
kolik	NN
kolina	NN
kolitis	NN
kolofon	NN
kologen	NN
koloid	NN
koloidal	NN
kolokasi	NN
kolokium	NN
kolom	NN
kolomben	DT
kolon	NN
kolone	NN
kolonel	NN
kolong	IN
koloni	NNS
kolonial	NN
kolonialis	NNS
kolonialisme	NN
kolonisasi	NN
kolonye	NNS
kolor	NN
kolorimeter	NN
kolorimetri	NNS
kolosal	NN
kolostomi	NN
kolostrum	NN
kolot	JJ
kolum	PRP$
kolumnis	NN
kolusi	NN
kom	VBD
koma	VBG
komaliwan	NN
koman	NN
komandan	NN
komandemen	NN
komanditer	NN
komando	NN
komaran	DT
kombinasi	NN
kombo	NN
komedi	NN
komedian	NN
komendur	VB
komensal	NN
komentar	NN
komentator	NN
komersial	JJ
komersialisasi	NN
komet	NN
komfortabel	JJ
komidi	NN
komik	NN
komikus	JJ
komis	NN
komisar	NN
komisariat	NNS
komisaris	NN
komisi	NN
komisioner	NN
komisura	NN
komit	NN
komite	NN
komitmen	NN
komoditas	NNS
kompak	NN
kompanyon	NN
komparasi	NN
komparatif	NN
komparator	NN
kompartemen	NN
kompas	NN
kompatibel	JJ
kompatibilitas	NN
kompatriot	NN
kompendium	NN
kompeni	NN
kompensasi	NN
kompes	NNS
kompeten	NN
kompetensi	NN
kompetisi	NN
kompetitif	JJ
kompetitor	NNS
kompi	NN
kompilasi	NN
kompilator	NN
komplain	NN
kompleksitas	NN
komplemen	NN
komplet	NN
komplikasi	NNS
komplikatif	NN
komplimen	NNS
komplot	NN
kompon	NN
komponen	NN
komponis	NNS
kompor	NN
kompos	NN
komposer	NN
komposisi	NN
komposit	JJ
komprador	NN
komprang	NN
komprehensif	NN
kompres	NN
kompresi	NN
kompresor	NN
kompromi	NN
kompromistis	NN
kompulsi	NNS
kompulsif	NN
komputer	NN
komputerisasi	NN
komtabilitas	JJ
komunal	JJ
komune	NN
komuni	JJ
komunikabilitas	NN
komunikan	NN
komunikasi	NN
komunikatif	NN
komunikator	NN
komunike	NN
komunis	NN
komunisme	NN
komunistis	NN
komunitas	NN
komutator	NN
komuter	NN
konan	DT
konco	NN
kondang	JJ
kondangan	NN
kondektur	NN
kondensasi	NN
kondensat	NN
kondensator	NN
kondensor	NN
kondisi	NN
kondom	NN
kondominium	NN
kondomisasi	NN
konduite	NN
konduksi	NN
konduktans	VBG
konduktimeter	NN
konduktivitas	NN
konduktor	NN
kondusif	NN
koneksi	NN
koneksitas	NN
konektor	NN
konfederasi	NN
konfeksi	NN
konferensi	NN
konfesi	NN
konfigurasi	NN
konfirmasi	NN
konflik	NN
konform	NN
konformitas	NN
konfrontasi	NN
konfrontatif	NN
kongenital	NN
kongesti	NN
kongkalikong	NN
kongko	NN
kongkoan	NN
kongkong	NN
kongkret	NN
konglomerasi	NN
konglomerat	NN
kongregasi	NN
kongres	NN
kongresis	NN
kongsi	NN
konifera	NN
konis	NNS
konjugan	NN
konjugasi	NN
konjungsi	NN
konjungtiva	NN
konjungtivitis	NN
konkaf	NN
konklusi	NN
konklusif	NN
konkomitan	NN
konkordansi	TO
konkordat	NN
konkret	NN
konkuren	JJ
konkurensi	NN
konkurs	NN
konoid	NN
konon	RB
konosemen	NNS
konotasi	NN
konotatif	NN
konperensi	NN
konsekuen	NN
konsekuensi	NNS
konseli	NN
konseling	VBG
konselor	NN
konsensus	NN
konsentrasi	NN
konsentrat	NN
konsentris	NN
konsep	NN
konsepsi	NN
konsepsional	JJ
konseptor	NN
konseptual	JJ
konseptualisasi	NN
konser	NN
konsertina	NN
konservasi	NN
konservatif	JJ
konservatisme	NN
konservator	NN
konservatorium	NN
konsesi	NN
konsili	NN
konsiliasi	NN
konsinyasi	NN
konsisten	NN
konsistensi	NN
konsistori	NN
konsol	NN
konsolasi	DT
konsolidasi	NN
konsonan	NN
konsorsium	NN
konspirasi	NN
konspiratif	NN
konspirator	NN
konstabel	JJ
konstan	JJ
konstanta	JJ
konstelasi	NN
konstipasi	NN
konstituante	NN
konstituen	NNS
konstitusi	NN
konstitusional	JJ
konstitusionalisme	NN
konstriktor	NN
konstruksi	NN
konstruktif	NN
konstruktivisme	NN
konsul	NN
konsulat	NN
konsulen	NN
konsuler	NN
konsultan	NN
konsultasi	NN
konsumen	NN
konsumer	NN
konsumerisme	NN
konsumsi	NN
konsumtif	NN
kontak	NN
kontaminasi	NN
kontan	JJ
konte	NN
konteks	NN
kontekstual	JJ
kontemplasi	NN
kontemplatif	NN
kontemporer	JJ
konten	NN
konter	NN
kontes	NN
kontestan	NN
kontet	NN
kontinen	NN
kontinental	NN
kontingen	NN
kontinu	JJ
kontinuitas	NN
kontinum	NN
kontol	NN
kontra	IN
kontrabande	VBG
kontrabas	NN
kontradiksi	NN
kontradiktif	NN
kontraindikasi	VBN
kontrak	NN
kontraksi	NN
kontraktor	NN
kontraktual	JJ
kontraproduktif	NN
kontras	NN
kontrasepsi	NN
kontraseptif	NNS
kontribusi	NN
kontributor	NNS
kontrol	NN
kontroversi	NN
kontroversial	JJ
konveks	NN
konveksi	NN
konvektif	NN
konvensi	NN
konvensional	JJ
konvergen	NN
konvergensi	NN
konversasi	NN
konversi	NN
konveyor	NN
konvoi	NN
konvulsan	NN
konvulsi	NN
konyak	NN
konyal	NN
konyan	DT
konyol	RB
kooperasi	NN
kooperatif	NN
kooperator	NN
kooptasi	NN
koordinasi	NN
koordinat	NN
koordinatif	NN
koordinator	NN
kop	NN
kopbal	NN
kopek	NN
kopel	NN
koperasi	NN
kopi	NN
kopilot	NN
kopling	NN
kopolimer	NN
kopong	NNS
kopra	NN
kopral	JJ
koprolit	NN
kopula	DT
kor	NN
koral	JJ
koralit	NN
korano	NN
korban	NN
korden	NNS
kordial	NN
kordit	NN
kordon	NN
kored	NN
korek	NN
koreke	JJ
koreksi	NN
korektif	NN
korektor	NN
korelasi	NN
korelatif	NN
korenah	NNS
koreng	NN
koreograf	NN
koreografer	NN
koreografi	NN
kores	NN
koresponden	NN
korespondensi	NN
koret	NN
koridor	NN
kornea	NN
kornet	VBN
koroh	JJ
korok	NNS
korona	NN
koronal	NN
koroner	NN
korong	NN
korosi	NN
korosif	NN
korporasi	NN
korporat	JJ
korporatif	JJ
korps	NN
korpulensi	NNS
korsase	NN
korsel	NN
korselet	NNS
korset	NN
korsleting	VBN
korteks	NN
kortikulus	NN
korting	NN
kortison	NN
korundum	NN
korup	NN
korupsi	NN
koruptif	NN
koruptor	NN
korve	NNS
kosakata	JJ
kosekan	DT
kosen	NN
koset	RB
kosinus	NN
kosmetik	NNS
kosmetolog	NN
kosmetologi	NN
kosmetologis	NN
kosmis	NN
kosmogoni	NN
kosmografi	DT
kosmologi	NN
kosmologis	NN
kosmopolitan	NN
kosmos	NN
kosong	JJ
kostum	NN
kota	NN
mara	RB
kotah	DT
kotak	NN
kotaklema	TO
kotek	VB
koteka	NN
koteng	NN
kotor	NN
kovalensi	JJ
kover	NN
koyak	NN
koyan	NNS
kram	NN
kraniologi	NNS
kraniometri	NNS
kraniotomi	NN
kranium	NN
krans	NN
krasis	NN
krayon	NN
kreasi	NN
kreatif	JJ
kreativitas	NN
kreator	NN
krebo	NN
kredibilitas	NN
kredit	NN
kredo	NN
krem	NN
kremasi	NN
krematori	NNS
krematorium	NN
kreol	NN
kreolin	NN
kreosol	NN
kresol	NN
kretin	NN
kribo	NN
krifoli	NNS
krim	NN
kriminal	JJ
kriminalis	JJ
kriminalisasi	NN
kriminalitas	NN
kriminolog	NN
kriminologi	NN
kriminologis	NN
kring	IN
krio	NN
kriofil	NN
kriogen	NN
krioterapi	NN
kripta	NN
kriptogam	NN
kriptografi	NN
kriptogram	NN
kriptol	NN
kripton	NN
krisan	NN
krisis	NN
krisma	NN
krisopras	NN
kristalisasi	NN
kristalografi	NNS
kristiani	NN
kristus	NN
kriteria	NNS
kriterium	NNS
kritik	NN
kritikus	NN
kritis	JJ
kritisi	NNS
kroco	NN
kroket	NN
kromat	NN
kromatid	NN
kromatin	NN
kromatis	JJ
kromatofor	NN
kromatografi	NN
kromit	NN
kromium	NN
kromo	NN
kromogen	NN
kromosom	NN
kroni	NN
kronik	NN
kronis	NN
kronisme	NN
kronobiologi	NN
kronologi	NN
kronologis	JJ
kronometer	NN
kru	NN
kruistik	NN
kruk	NN
krusial	JJ
krustasea	NNS
ksi	NN
ku	IN
kuadran	NN
kuadrat	NN
kuadratika	JJ
kuadratur	NN
kuadratus	NN
kuadrupel	NN
kuadrupleks	TO
kuah	NN
kuai	NN
kualat	VBN
kuali	NN
kualifikasi	NN
kualitas	NN
kualitatif	NN
kualon	NN
kuang	NN
kuangwung	NN
kuantifikasi	NN
kuantitas	NN
kuantitatif	NN
kuantum	NN
kuap	NN
kuar	NN
kuari	NN
kuark	NN
kuarsa	NN
kuart	NN
kuartal	NN
kuarter	NN
kuartet	NN
kuartil	NNS
kuas	NN
kuasa	NN
kuasar	NN
kuasi	NN
kuat	JJ
kuaya	TO
kuayan	NN
kubah	NN
kubik	NN
kubis	NN
kubisme	NN
kubit	NN
kuboid	NN
kubti	NN
kubu	NN
kubung	TO
kubur	NN
kubus	NN
kucak	NN
kucam	NN
kucel	VBN
kucica	NN
kucing	NN
kucir	NN
kuda	NN
kudai	IN
kudang	NN
kudap	NNS
kudeta	NN
kudian	RB
kudis	NNS
kudu	MD
kuduk	NN
kudus	NN
kue	NN
kueni	NN
kuesioner	NN
kuetiau	NNS
kui	IN
kuih	NN
kuil	NN
kuilu	NN
kuin	IN
kuini	NN
kuinina	NN
kuintal	NN
kuintil	NN
kuir	NN
kuis	NN
kuit	NN
kuitansi	NNS
kujang	NN
kujur	DT
kujut	NN
kuk	NN
kukila	TO
kuku	NN
kukuh	JJ
kukul	JJ
kukup	RB
kukus	VBN
kulak	NN
kulan	NN
kulat	NN
kulawangsa	NN
kuli	NN
kuliah	NN
kulimat	RB
kuliner	NN
kulir	TO
kulit	NN
kulkas	NN
kulminasi	NN
kulot	RB
kult	NN
kultivar	NNS
kultivasi	NN
kultur	NN
kultural	JJ
kulub	PRP
kulup	NN
kulur	NN
kulut	NNS
kumal	NN
kuman	NNS
kumanga	TO
kumat	NN
kumbah	VBN
kumbang	NN
kumbik	IN
kumbu	NN
kumbuh	NN
kumena	NN
kumico	NN
kumis	NN
kumpal	NN
kumpi	WDT
kumpul	VB
kumuh	NN
kumulasi	NN
kumulatif	JJ
kumulus	NN
kumur	NN
kumus	DT
kunani	WRB
kunca	IN
kunci	NN
kuncup	NN
kundai	VB
kundi	CC
kundur	NN
kunduran	NN
kungkung	NN
kuning	NN
kunjung	NN
kuno	NN
kunta	NN
kuntul	NN
kuntum	NN
kunyah	NN
kunyam	NN
kunyit	NN
kunyuk	NN
kuorum	NN
kuosien	NNS
kuota	NN
kup	VB
kupa	NN
kupahan	NN
kupak	NN
kupas	VBN
kupat	NN
kupi	VB
kupil	NN
kuping	NN
kupluk	NN
kuprum	NN
kupui	NNS
kur	WRB
kura	IN
kurai	IN
kurang	RBR
kurap	NN
kuras	WDT
kurasani	TO
kuratif	NN
kurator	NN
kuratorium	NN
kurau	NN
kurawal	RB
kurban	NN
kurcaci	NN
kuren	DT
kuret	NN
kuria	VBG
kurik	NN
kurikuler	NN
kurikulum	NN
kuring	NN
kuriositas	NN
kurir	NN
kurium	NN
kurkuma	NN
kurma	NN
kurs	NN
kursi	NN
kursif	NN
kursor	NN
kursus	NNS
kurtase	NN
kurun	NN
kurung	NNS
kurus	WDT
kurva	NN
kurvatur	NN
kusam	NN
kusau	NN
kusen	NNS
kusik	NN
kusir	DT
kuskus	JJ
kuspis	NN
kusta	NN
kusut	VBN
kutak	NN
kutang	NN
kutat	NN
kuteks	NN
kuteri	NN
kuti	RB
kutikula	NN
kutil	NNS
kuting	VB
kutip	NN
kutu	NN
kutub	NNS
kutuk	NN
kutung	VBN
kutut	NN
kuud	NNS
kuwur	NN
kuyu	RB
kuyup	VBN
kwartet	NN
kweni	RB
laba	NN
labak	RBR
labas	IN
labil	JJ
labirin	NN
laboran	PRP
laboratoris	NNS
laboratorium	NN
labrakan	NN
labu	JJ
labuh	NN
labun	NN
labur	JJ
lacak	NN
ladan	IN
ladang	NN
ladu	DT
ladung	NN
lafal	NN
laga	IN
lagak	NN
lagam	NN
lagan	RB
lagi	RB
lagiah	RB
lagu	NN
lahak	JJ
lahan	NN
lahap	NN
lahar	NN
lahir	NN
lahiriah	RB
lai	TO
laici	NN
laik	NN
lailah	NN
lain	JJ
lais	NN
lajak	NN
lajang	JJ
lajat	DT
laju	NN
lajur	NN
lakab	NN
lakak	NNS
lakar	NN
lakara	JJR
laki	NNS
lakmus	NN
laknat	NN
lakon	NN
lakonik	NN
lakonisme	NN
laksamana	JJ
laksana	NN
laksatif	NN
laktase	NN
laktat	NN
laktogen	NN
laktoglobulin	NN
lakton	NN
laktosa	NN
laku	NN
lakuna	NN
lalai	NN
lalang	NNS
lalat	NNS
lalu	RB
lintas	NN
lama	RB
laman	NN
lamang	RB
lambak	NN
lamban	VB
lambang	NN
lambar	NN
lambat	VB
lambe	NN
lambu	NN
lambung	NN
lamela	DT
laminasi	NN
lampai	NN
lampan	NN
lampar	NNS
lampas	NNS
lampau	NN
lampeni	NN
lampes	NNS
lampin	NN
lampion	NNS
lampor	NNS
lampu	NN
lamtoronisasi	NN
lamun	IN
lanang	NN
lanar	NN
lanbau	NN
lanca	NN
lancang	NN
lancar	RB
lancip	NN
lancung	NN
lancur	VBN
landa	NN
landai	VBG
landak	NN
landap	NN
landas	NN
landrad	NN
landuk	VB
landung	VBG
landur	VB
lang	RB
langen	RB
langgah	NN
langgai	NN
langgam	NN
langgan	NN
langgang	VBN
langgas	JJ
langgayan	NN
langgeng	VBG
langguk	NN
langgung	NN
langi	VBZ
langir	RB
langis	NN
langit	NN
langka	NN
langkah	NN
langkai	NNS
langkan	NN
langkara	NN
langkas	NN
langkau	NN
langkisan	TO
langkong	VBN
langkup	NN
langlai	NN
langlang	NN
langsam	RB
langsar	JJ
langsing	NN
langsir	NNS
langsung	RB
langu	NN
lanja	NN
lanjak	RB
lanjam	NN
lanjau	PRP
lanji	NN
lanjuk	DT
lanjung	NN
lanjur	CC
lanjut	NN
lansia	RB
lansir	NN
lanskap	NN
lantah	NN
lantai	NN
lantam	NN
lantan	NN
lantang	NN
lantanum	NN
lantas	RB
lantera	NN
lantik	NN
lantip	NN
lantun	NN
lantung	NN
lantur	NN
lanun	NNS
lanyah	NN
laocu	NN
laoteng	NN
lapak	NN
lapang	NN
lapar	NN
laparoskopi	NN
lapik	NN
lapir	NN
lapor	NN
lapuk	JJ
lapun	NN
larah	NN
larak	TO
larang	NN
larap	JJ
laras	NN
larat	NN
largo	RB
lari	VB
larik	NN
laring	NN
laringal	NN
laringitis	NN
laringoskop	NN
laris	VBG
larnaks	NN
larung	DT
larut	RB
larvarium	NN
las	DT
lasa	VB
lasah	NN
lasak	VBN
lasat	VBD
lasi	VB
lasinia	NN
laskar	NNS
lat	NNS
lata	NN
latah	NN
latar	NN
latas	NNS
laten	VB
latensi	NN
laterit	NN
latih	NN
latis	VBN
latuk	NNS
lauk	NN
laun	NN
lauya	NN
lavendel	NN
lawa	NN
lawak	NN
lawamah	IN
lawan	NN
lawang	NN
lawas	JJ
lawat	NN
lawazim	NN
lawe	NN
lawina	NN
layah	NN
layak	JJ
layan	NN
layang	NN
layar	NN
layas	NN
layu	VBD
layuh	NN
layuk	NN
layung	NN
laza	JJ
lazim	JJ
lebah	NN
lebam	NNS
lebar	JJ
lebaran	NN
lebat	JJ
leber	NN
lebih	RBR
lebuh	NN
lebuk	JJ
lebum	NN
lebun	VB
lecah	NN
lecek	VBN
lecer	NN
lecet	NNS
leci	NNS
lecuh	NN
lecun	NN
lecur	NN
ledak	JJ
ledang	VBN
ledek	NNS
ledeng	NN
ledes	VBN
ledos	NNS
ledre	IN
leduk	NN
ledung	NN
lefa	NN
lega	NN
legalisasi	NN
legalitas	NN
legap	NN
legar	VBD
legasi	NN
legat	NN
legataris	NNS
legato	NN
legator	NN
lege	NN
legen	NN
legenda	NN
legendaris	JJ
leges	NNS
legi	NNS
legih	NN
legio	NN
legislasi	NN
legislatif	JJ
legitimas	RB
legitimasi	NN
legiun	NN
legu	NN
legum	NN
legung	NN
leher	NN
leja	NN
lejang	NN
lejar	VBN
lejas	NNS
lejok	VB
leka	NN
lekap	NN
lekas	NN
lekat	NN
lekemia	NN
lekit	NN
lekok	NN
leksem	NN
leksikal	JJ
leksikograf	NN
leksikografi	NNS
leksikografis	NN
leksikon	NN
leksis	NN
lekton	NN
lektor	NN
lektur	NN
leku	NN
lekuk	NN
lekun	NN
lelah	VBN
lelai	RB
lelaki	NN
lelancur	NN
lelang	NN
lelap	RB
lelatu	NN
lele	NN
leleh	VBG
lelembut	NN
lelemuku	DT
lelep	NN
leler	VBN
leles	VB
lelet	VB
leli	NNS
leluasa	RB
lelucon	NN
leluhur	NNS
lelung	NN
lelungit	NN
lema	NN
lemah	JJ
lemak	NN
lemari	NNS
lemas	NN
lembaga	NN
lembah	NN
lembai	DT
lembak	VB
lembam	JJ
lembang	NN
lembap	NN
lembar	NN
lembayung	NN
lembega	NN
lembek	NN
lembidang	NNS
lembing	NN
lembu	NNS
lembung	NN
lembur	NN
lemburu	PRP
lembut	JJ
lemender	NN
lempar	NN
lempari	NN
lempeng	NNS
lempuk	NN
lempung	NN
lenan	NN
lencana	NN
lenceng	NN
lencet	NN
lencong	NN
lenda	NN
lendaian	IN
lendir	NN
lendut	NN
leng	NN
lenga	NN
lengah	NN
lengak	RB
lengan	NN
lengang	RB
lengar	NN
lengas	NNS
lenge	RB
lenggak	NN
lenggang	NN
lenggek	NN
lenggor	NN
lenggundi	NN
lengkang	NN
lengkap	JJ
lengkara	JJ
lengkeng	NN
lengket	NN
lengking	VBG
lengkitang	NN
lengkok	NN
lengkong	NN
lengkuas	NN
lengkung	NN
lengkur	NN
lengoh	NN
lengong	DT
lengser	VBD
lening	NN
lenis	NN
lenjan	NN
lensa	NNS
lenser	NNS
lenset	NN
lenso	NNS
lentera	NN
lentik	NN
lentong	NN
lentuk	NN
lentum	VBD
lentur	NN
lenyah	NN
lenyai	VBG
lenyak	NN
lenyap	NNS
lenyet	VBG
lepa	NN
lepai	NN
lepak	NN
lepas	JJ
lepat	RB
lepau	DT
lepe	NN
lepek	NNS
leperi	NNS
lepet	DT
lepih	NN
lepik	NNS
lepit	NN
lepok	NNS
lepot	NN
lepra	NN
lepu	NN
lepuh	NNS
lepuk	NN
lepur	NN
lerai	JJ
lerak	NN
lerang	NNS
lerap	NN
lereng	NN
leret	NN
lerok	NN
les	DT
lesa	NN
lesap	VBN
lesbi	JJ
lesbianisme	NN
lesi	NNS
lesing	NN
lesir	NN
lesit	NN
lesot	VBG
lestari	JJ
lestek	VBG
lesu	JJ
lesung	NN
lesus	NN
leta	NNS
letak	NN
letal	NN
letargi	NN
leter	VBG
letih	NNS
letik	NN
leting	NN
letis	NN
letnan	NN
letos	DT
letuk	VB
letung	VB
letur	NN
leukosit	NNS
levertran	NN
levirat	DT
lewa	NN
lewah	RBR
lewat	IN
lezat	JJ
liabilitas	NN
lian	JJ
liang	NN
liangliong	NN
liat	NN
liau	RB
libei	NN
liberalis	NN
liberalisasi	NN
liberalisme	NN
libero	JJ
libidis	NN
librasi	NNS
libur	NN
licak	JJ
licau	NN
lici	NN
licik	VBG
licin	NN
licurai	NNS
lidah	NN
lidas	NN
lidi	NNS
lidid	DT
lifo	VBG
liga	NN
ligamen	NNS
ligan	NN
ligar	NN
ligas	NNS
ligasi	NN
ligatur	NN
ligih	NN
lignit	NN
lihai	NN
lihat	VB
lik	JJ
likas	JJ
likat	JJ
liku	NNS
likuid	NN
likuida	NN
likuidasi	NN
likuiditas	NN
likur	NN
lilau	NNS
lilin	NN
liman	NN
limar	NN
limau	NN
limbah	NN
limbai	NN
limbuk	NN
limbung	VBN
limfa	NN
limfangioma	NN
limfatik	NNS
limfoblas	NN
limfoblastoma	NN
limfografi	NN
limfoma	NN
limfosit	NNS
limfositopenia	NN
limfositosis	NN
limitasi	NNS
limitatif	JJ
limpa	NN
limpah	NN
limpas	NN
limpung	NN
limun	NN
limusin	NN
limut	NN
linang	NN
lincah	NN
lincun	NN
lindak	NN
lindang	NN
lindas	NN
lindik	NN
lindu	NNS
lindung	VBN
lindur	NN
ling	VBG
lingar	NNS
lingga	NN
linggayuran	NN
linggis	NN
lingkar	NN
lingkawa	NN
lingkis	NN
lingkung	NN
lingkup	NN
linglung	VBN
lingsa	NN
lingsu	NN
linguis	JJ
linguistik	NNS
lini	VB
linier	NN
linjak	DT
linsang	NN
lintah	NN
lintang	NN
lintibang	NN
lintir	NN
lintuh	JJ
linu	JJ
linyak	DT
liontin	NN
lipan	VBG
lipas	NN
lipat	VBG
lipit	VBG
lipoksidase	NN
lipstik	NN
lipu	DT
lipur	NN
liput	NN
lir	TO
lirih	RB
lirik	NNS
liris	JJ
lisah	NN
lisan	JJ
lisensi	NN
lisis	NN
lisong	NN
listrik	NN
lisu	NN
lisus	NN
lisut	JJ
litah	NN
literator	NN
literer	JJ
litium	NN
litografi	NN
litologi	NN
litoral	NN
litosfer	RB
litotes	NNS
litotomi	NN
litsus	NN
liturgi	NN
liturgis	JJ
liuk	NN
liur	NN
liut	NNS
liwat	IN
lo	DT
loak	NN
loba	JJ
lobak	NN
loban	NNS
lobi	NN
locot	NN
lodong	NN
logam	NN
logaritma	NN
logat	VBN
logika	NN
logistik	NNS
logopedia	NN
logotip	NN
loji	NN
lokakarya	NN
lokal	JJ
lokalisasi	NN
lokan	JJ
lokap	NN
lokasi	NN
lokastiti	NN
lokatif	JJ
lokawarta	PRP$
loket	NN
lokia	NN
lokio	NN
lokomobil	NN
lokomotif	JJ
loksek	NN
loksun	NN
lokus	NN
lokusi	NN
loleng	NN
lolos	VB
lomba	NN
lombar	JJ
lombong	NN
lomek	NN
lomot	NN
lompat	NN
lompayang	NNS
lompok	NN
loncat	NN
loncek	NN
lonceng	NN
londang	NN
loneng	RB
longgar	JJ
longo	RB
longok	NN
longser	NN
longsor	NN
longtorso	NN
lonjak	NN
lonjong	NN
lontok	NN
lontong	NN
lonyok	RB
lopak	NN
lopek	NN
lor	PRP$
lorat	NN
lorong	NN
lorot	NN
los	DT
losion	NN
losmen	NN
loteng	JJ
lotis	IN
lotre	NN
lowong	NN
loyak	NN
loyalis	NNS
loyalitas	NN
loyang	NN
loyo	JJ
loyong	RB
luak	JJ
luap	NN
luar	IN
luas	JJ
luat	VBN
luban	NN
lubang	NN
lubuk	DT
lucah	NN
lucu	NN
ludah	NN
ludat	NN
ludes	VBN
lues	NN
lugas	DT
lugu	DT
luhur	NN
luik	NN
luk	RB
luka	NNS
lukat	NN
lukis	NN
luku	NN
lukut	NN
lulai	NN
luli	NN
luluk	NN
lulum	NNS
lulur	NN
lulus	NN
lumai	NN
lumang	JJ
lumar	NN
lumayan	RB
lumbung	NN
lumer	VBN
lumpia	NN
lumpuh	VBN
lumpuk	NN
lumrah	NN
lumsum	NNS
lumuh	NN
lumus	VB
lumut	NN
lunak	JJ
lunas	NNS
lunau	NN
luncur	NN
lundi	NN
luner	NNS
lungguh	VBG
lungkang	NN
lungkum	NNS
lunglai	NN
lungse	NN
lungsung	NN
lungsur	NN
lungun	NNS
lunjur	NN
lunta	NN
luntur	NN
lunyah	VBG
lunyai	VBZ
lup	NN
lupa	NN
lupi	NNS
lupuh	NN
lupuk	VB
luput	NN
lurik	VBN
luru	NN
luruh	NN
lurus	NN
lus	NN
lusin	NN
lusuh	NN
lut	NN
lutu	NN
lutut	NN
luweng	NN
luwes	NN
luyu	NN
maab	NN
maaf	NN
mabuk	NN
macakal	NN
macam	NN
macan	NN
macet	NN
macis	JJ
madali	JJ
madinding	VBG
madona	NN
madu	NN
mafela	NNS
mafioso	NN
magang	NN
magasin	NN
magersari	TO
magfirah	VB
magis	RBR
magister	NN
magistrat	NN
maglub	NN
magnetik	JJ
magnetis	JJ
magnetisme	NN
magnetit	NN
magnitudo	NN
magrib	VBG
magun	NN
maha	RB
mahabah	NN
mahajana	NN
mahakarya	NN
mahakuasa	NN
mahal	JJ
mahamen	PRP
mahamenteri	NN
maharesi	NN
mahasiswa	NN
mahasiswi	NN
mahasuci	NN
mahir	JJ
mahkamah	NN
mahkota	NN
mahligai	NN
mahoni	NN
mahsul	NN
mahwu	NN
mahyong	NN
mai	MD
maizena	NN
maja	MD
majaan	DT
majakeling	NN
majalah	NN
majas	IN
majasi	NNS
majelis	NNS
majemuk	NN
majikan	NN
maju	JJ
majuh	VB
majusi	NN
maka	RB
makadam	NN
makalah	NN
makam	NN
makan	NN
makantah	NN
makanya	NN
makaopo	NN
makar	IN
makaroni	NN
makbul	JJ
makcik	NN
makelar	NN
maket	NN
makhluk	NN
makiyah	NN
maklum	NN
maklumat	NN
makmal	NN
makmur	JJ
makna	NN
makrame	NN
makro	NN
makroekonomi	NNS
makrofita	NN
makrohistori	DT
makrokosmos	NN
makrokriminologi	NNS
makromelia	NNS
makrometeorologi	NNS
makromolekul	NNS
maksiat	NN
maksila	NN
maksimal	NN
maksimum	NN
maksud	NN
maktab	NN
maktub	NN
makua	NN
makul	JJ
makula	NN
makyong	NN
mal	NNS
mala	JJ
malafide	JJ
malafungsi	NNS
malah	RB
malaikat	NN
malaikatulmaut	NN
malakofili	NNS
malam	NN
malang	JJ
malap	NN
malapetaka	NN
malapraktik	NN
malas	JJ
malasia	NN
maldistribusi	TO
malih	JJ
malim	JJ
maling	NN
malis	NN
malnutrisi	NN
maltosa	NN
malu	NN
malun	NN
mam	NN
mamai	NN
mamalia	NNS
maman	NN
mambang	NN
mambek	JJ
mambung	NN
mami	NN
mamlakat	NN
mamografi	NN
mampir	NN
mampu	JJ
mampung	MD
mampus	JJ
manai	NN
manajemen	NN
manajer	NN
manajerial	NN
manakala	IN
manakan	TO
manalagi	NN
manau	NN
mancanegara	RB
mancawarna	NN
mancung	JJ
mancur	NN
manda	NNS
mandah	NN
mandam	PRP
mandat	NN
mandataris	NN
mandek	NN
mandi	NN
mandibula	JJ
mandiri	JJ
mandor	NN
mandril	IN
mandrin	NN
mandul	NNS
maneken	NN
manfaat	NNS
mang	NN
mangas	NNS
mangau	NN
mangayubagya	NN
mangga	NN
manggis	NN
manggung	NN
mangkak	JJ
mangkanya	NN
mangkar	NN
mangkas	PRP
mangkat	VB
mangkel	VBG
mangkih	RB
mangkir	NNS
mangkok	NN
mangkuk	NN
mangkus	NN
mangsa	NN
mangu	NN
mangun	NN
mangut	VBG
mani	NNS
maniak	NN
manifes	NN
manifestasi	NN
manik	NNS
manikdepresi	NN
manikur	NN
manipol	NN
manipulasi	NN
manipulatif	NN
manis	NN
manja	JJR
manjur	NN
manset	NN
mansiang	RB
mantan	NN
mantap	JJ
manten	VB
mantiki	NN
mantu	NN
mantuk	NN
manufaktur	NN
manufakturing	NN
manuk	NNS
manunggal	JJ
manusia	NN
manusiawi	NN
manuskrip	NNS
manut	NN
manuver	NN
manuwa	NN
manyala	JJ
mapan	VBN
marah	JJ
maraja	NN
marak	NN
maraton	NN
marbut	NN
marcapada	RB
mardud	NN
mare	JJ
maret	NN
marga	JJ
margarin	NN
margasatwa	NN
marginalisasi	NN
marhaenisme	NN
mari	JJ
marikh	NN
marimu	NN
marinir	NNS
mariyuana	NN
marka	NN
markado	NN
markah	NNS
markas	NNS
markasit	NN
markis	VBG
markisa	NN
markonis	PRP
marmelade	NN
marmer	NN
maro	NN
marsekal	NNS
martabat	NN
martir	NN
mas	CC
masa	NN
masak	NN
masakat	NN
masalah	NN
masam	NN
masase	NN
masektomi	NN
maserasi	NN
masif	JJ
masih	RB
masin	DT
masinal	IN
masinis	NN
masjid	NN
maskapai	NN
maskara	NN
maskat	NNS
maskawin	NNS
masker	NN
maskon	NN
maskot	NN
maskulin	NN
maskulinitas	NN
maslahat	NN
masoi	NN
masokisme	NN
massa	NN
massal	NN
mastautin	NN
mastektomi	NN
mastik	JJ
mastuli	NNS
masturbasi	NN
masuk	NN
masyarakat	NN
masygul	NN
masyhur	JJ
mata	NN
matahari	NN
matakao	NNS
matalamat	CC
matan	NN
matang	NN
matematika	NNS
matematikawan	NN
matematikus	NN
matematis	JJ
materi	NN
materialis	NN
materialisme	NN
materialistis	JJ
materiil	NN
mati	NN
matlak	NN
maton	JJ
matras	NN
matriks	NN
matrikulasi	NN
matris	NN
matros	NN
matur	NN
maturitas	DT
mau	NN
maukuf	NNS
maupun	IN
mawar	VBD
mawas	NN
mawon	NN
mawut	JJ
mayat	NN
mayoritas	NN
mazbah	DT
mazhab	NN
mazi	NN
mazkur	DT
mazmur	NN
mbak	NN
mbeling	VBG
medali	NN
medalion	NN
medan	NN
mede	NN
mediasi	NN
medik	JJ
medikamentosa	NN
medikasi	DT
medikus	NNS
medio	NN
medis	NN
meditasi	NN
mediterania	NN
medu	NN
medula	NN
megafon	NN
megah	NN
megalit	NNS
megalitikum	JJ
megalosit	NN
megaproyek	NN
megar	NN
meger	VBN
mei	MD
meja	NN
mejam	NN
mejana	NN
mekanik	JJ
mekanika	NNS
mekanis	JJ
mekanisasi	NN
mekanisme	NN
mekap	NN
mekar	NN
meko	JJ
mekonium	NN
melabuai	TO
melambang	NN
melangkup	VBG
melankolia	NN
melankolis	NN
melar	JJ
melas	NN
melase	NNS
melati	NN
melawah	RB
melek	NN
meler	NNS
melesek	NN
meleset	NNS
melodi	NN
melodika	NN
melotot	VBN
melukut	NNS
melulu	RB
melur	NNS
memang	RB
memar	VB
membal	VBG
memble	VBG
membran	NN
memek	VB
memoar	NNS
memorat	VBN
memori	VB
mempan	VBG
mempelai	NN
mempelam	NN
mempelas	VB
mempelasari	VB
mempening	TO
memper	NN
mempitis	VBG
mempurung	VB
memutah	NN
menaga	VB
menampun	VBG
menang	VB
menantu	NN
menara	VB
menat	NN
menceng	VBG
menceret	VBG
mencit	NN
menclok	VBG
mencok	VB
mencong	VB
mencret	VB
mendak	VB
mendapa	VBN
mendiang	RB
mendikai	VBG
mendira	TO
mendonan	NN
mendong	VB
mendu	VB
mendung	VB
mendur	TO
mendut	VB
menep	VBG
menepaat	NN
mengangah	NN
mengap	NN
mengapmendam	NN
mengerawan	VB
mengerna	VB
mengga	NN
menggala	NN
menggusta	VB
mengi	DT
mengicip	VBG
mengirat	VBN
mengkali	VB
mengkaras	VBG
mengkelan	TO
mengkerang	TO
mengkeret	VBG
mengkirai	NN
mengkona	RB
mengok	VB
mengor	VB
meni	TO
meniskus	VB
menit	NN
menjelai	VB
menong	NN
menor	RBR
mensiang	VBN
menstruasi	NN
mensurasi	VB
mentah	VB
mentak	DT
mentalitas	VB
mentari	VB
mentas	VB
mentega	VB
mentereng	NN
menteri	NN
mentigi	NN
mentimun	VB
mentis	IN
mentok	VB
mentol	VB
mentolo	NN
mentora	NN
menung	VB
menur	VBN
meong	NN
merajak	NN
merakan	NNS
merambai	VBG
merambung	NN
merana	JJ
merang	NN
meranggi	NN
merangu	VBG
merat	TO
merawal	NN
mercon	NNS
mercu	NN
mercusuar	NN
merdangga	NN
merdeka	JJ
merdesa	NN
merdinah	NN
merdu	JJ
merduk	NN
merek	NN
mereka	PRP
merem	VB
merembung	RB
mergat	NNS
mergul	VBG
meri	NN
meriam	NN
meriang	NN
merica	NN
merih	NNS
merik	NN
merjan	NN
merkuri	NN
merkurium	NN
merkurius	NN
merkuro	NN
merkurokrom	NN
merlilin	DT
merot	NNS
merpati	NN
merpaud	NN
merserisasi	NN
merta	NN
mertamu	PRP$
mertega	IN
mertua	NN
mes	PRP$
mesara	NN
mesin	NN
mesiu	NN
meski	IN
mesolitik	JJ
mesolitikum	JJ
mesra	RB
mesti	MD
mestika	MD
mesum	JJ
mesut	JJ
metabolik	NN
metabolis	NN
metabolisme	NN
metabolit	NNS
metafisik	JJ
metafisika	NNS
metafora	NN
metaforis	JJ
metah	NN
metai	NN
metalik	NN
metalografi	NN
metalurgi	NN
metalurgis	NN
metamorf	JJ
metamorfosis	NN
metana	NN
metanol	NN
metari	VBG
mete	NN
meteorologi	NN
meterai	NN
metil	NN
metode	NN
metodik	JJ
metodis	JJ
metodologi	NN
metrik	JJ
metrologi	NN
metronom	NN
metroragia	NN
metrum	NNS
mewah	NN
mewari	TO
mewek	VB
mezanin	NN
mezbah	NN
mi	PRP$
miak	VBG
miana	NNS
midar	NN
mieloma	NN
migrain	NN
migran	NN
migrasi	NN
migren	NN
miiofili	NN
miju	PRP$
mik	WP
mikat	NN
mikologi	NN
mikotoksin	NN
mikro	NN
mikroanalisis	NN
mikroangiopati	NN
mikrob	NN
mikrobiologi	NN
mikrobiologis	NN
mikrobus	NN
mikroekonomi	NNS
mikrofag	NNS
mikrofarad	NNS
mikrofilm	VBG
mikrofon	NN
mikrofotografi	NN
mikrograf	NN
mikrogram	NNS
mikrohabitat	NNS
mikroklimat	NN
mikrokomputer	NN
mikrokosmos	NN
mikrolinguistik	NN
mikrolit	NN
mikromanipulasi	NN
mikrometer	NN
mikrometri	NNS
mikron	NN
mikroorganisme	NNS
mikroprosesor	NN
mikrosefalia	NN
mikroskop	NN
mikroskopis	NN
mikrotom	NN
mikrovilus	NN
mikrowatt	NN
mikser	NN
miksoedema	NN
mil	CD
milenium	NN
miliampere	RB
miliar	CD
miliarder	NN
miliarwan	NN
milieu	NN
miligram	NNS
milik	NN
milimeter	NN
milimol	NN
milioner	NN
milisi	NN
militan	NN
militansi	NN
militer	JJ
militerisme	NN
militeristis	NN
miliun	NNS
miliuner	NNS
milivolt	NN
mim	PRP
mimbar	NN
mimi	NN
mimik	JJ
mimisan	NN
mimpi	NN
min	PRP
minat	NN
minder	RBR
mindi	PRP
mindoan	NN
mineralisasi	NN
mineralogi	NNS
minggat	VB
minggir	NN
minggu	NN
miniatur	NN
minikar	NN
minim	NN
minoritas	NN
minta	NN
mintuna	NNS
minum	NN
minyak	NN
mioma	NN
miop	VBN
miopia	NN
mipis	NN
mirah	NN
mirakel	NN
mirat	NNS
mirih	NN
miring	NNS
mirip	JJ
miris	NN
mirmekofili	NN
mirmekologi	NN
misai	NN
misal	NN
misi	NN
misil	NN
misiologi	NNS
misionaris	NNS
misioner	JJ
miskin	JJ
miskram	NN
mispersepsi	NN
mistar	NN
misteri	NN
misterius	JJ
mistik	JJ
mistis	JJ
mistisisme	NN
misuh	VB
mitasi	NN
mitisida	JJ
mitologi	NN
mitologis	JJ
mitos	NN
sejajar	NN
mobil	NN
mobilet	NN
mobilisasi	NN
mobilitas	NN
mobokrasi	NN
modalitas	NNS
moderat	NN
moderato	NN
modernisasi	NN
modernisme	NN
modernitas	NN
modifikasi	NN
modis	JJ
modul	NN
modulasi	NN
mofet	NN
moga	MD
mogok	NN
mohon	NN
mojah	NN
mok	NN
moka	NNS
moke	NN
moko	NN
mola	NN
molek	NN
molekul	NN
molekuler	NN
moler	NN
molibden	NN
molibdenum	NN
molor	NN
momen	NN
momental	JJ
momok	NN
monarki	NN
moncong	NN
moncor	NN
mondial	JJ
mondok	NN
moneter	JJ
monggol	NN
mongolisme	NN
monisme	NN
monodrama	NN
monogami	NN
monogini	NN
monografi	NN
monokarpa	NN
monoklin	NN
monoklinal	NN
monokotil	NN
monokotiledon	NN
monokrasi	NN
monokrom	NN
monokromator	NN
monoksida	NN
monokultur	NN
monolitik	JJ
monolog	NN
monopoli	NNS
monopolistik	JJ
monorel	NN
monosakarida	NNS
monosit	NNS
monoteis	NN
monoteisme	NN
monotipe	NN
monoton	JJ
montase	NN
montir	NN
montit	NN
montok	NN
monumen	NN
monyet	NN
mopit	NN
moralis	JJ
moralisme	NN
moralitas	NN
morbiditas	NN
morfem	NN
morfemis	NN
morfin	NN
morfinis	NN
morfofonologi	NNS
morfogenesis	NN
morfologi	NN
moril	NN
mortalitas	NN
mortir	NN
mosaik	NN
mosi	NN
moster	NN
motivasi	NN
moto	NN
motorik	NN
motoris	NN
moyang	NNS
mozaik	NN
mu	PRP
mua	NN
muak	VBN
mual	NN
mualaf	NN
mualamat	NNS
muara	JJ
muas	VB
muasir	JJ
muat	NN
mubah	NN
mubazir	NN
mubut	NN
muda	JJ
mudah	JJ
mudarat	NN
mudat	VBN
mudik	VBG
mudun	RB
mufakat	NN
muflis	NN
muhami	NN
muharam	VBN
muhibah	NN
muhit	NN
muhtasyam	NN
muih	NNS
mujahadat	NN
mujahidin	NN
mujair	NN
mujarab	JJ
mujtamak	DT
mujur	RB
muka	NN
mukadam	PRP
mukadimah	JJ
mukaram	NN
mukjizat	NNS
mukminin	NNS
mukosa	NN
muktamad	JJ
mula	IN
mulai	NN
mulas	NNS
mulato	NN
mulia	JJ
muliawan	JJ
mulsa	NN
multibahasa	JJ
multibahasawan	JJ
multidimensi	NN
multidisipliner	NN
multietnik	NN
multifungsi	NN
multiguna	NN
multikultur	JJ
multikulturalisme	NN
multilingualisme	NN
multimilioner	NN
multinasional	JJ
multipel	NN
multipleks	NN
multiplikasi	NN
multiplikator	NN
multiseluler	NN
muluk	NN
mulur	NN
mulus	NN
mulut	NN
mumayiz	PRP
mumbul	NNS
mumbung	IN
mumi	NN
mumifikasi	VBN
mumpung	IN
mumpuni	VBN
mumuk	NN
munafik	NN
munafikin	NN
munajim	NN
munasabah	JJ
muncang	VB
munci	NN
muncrat	NN
muncul	VB
muncus	NN
mundam	NN
munding	NN
mundu	NN
mundur	JJ
mung	RB
munggu	NN
mungil	JJ
mungkar	JJ
mungkin	RB
mungkir	NN
mungsi	NN
mungut	NN
munjung	NN
muntaber	VBG
muntah	NN
muntu	MD
munyuk	NNS
mupus	NN
mur	NN
mura	DT
murah	NN
murai	NN
muram	NN
murang	NN
muras	NN
murbei	NN
murid	NN
muring	VBG
murka	NN
murtad	NN
murung	NN
murup	VBN
murus	NN
mus	PRP
musabab	NN
musafir	NN
musang	NN
mushaf	NNS
musibah	NN
musik	NN
musikal	JJ
musikalisasi	NN
musikalitas	NN
musikolog	NN
musikologi	NNS
musikus	NN
musim	NN
musisi	NNS
muskovit	NN
muslih	NN
muslihat	NNS
musnah	NN
muspra	IN
mustahak	PRP
mustahil	JJ
mustamik	NN
musuh	NN
musyarakah	NN
musyarakat	NN
musyarik	VBG
musyawarah	NN
musytari	NN
mutah	NN
mutakadim	NN
mutakalim	NN
mutakhir	JJ
mutalaah	NN
mutan	NNS
mutasi	NN
mutiara	NN
mutilasi	NN
mutisme	NN
mutlak	NN
mutu	NN
mutualisme	NN
mutung	JJ
muwafakat	PRP
muwakil	NN
na	IN
naam	NN
nabati	NN
nabi	NN
nada	NN
nafar	RB
nafkah	NN
nafsu	NN
nafta	NN
naftalena	NN
naga	NN
nagara	NN
nagasari	NN
nahdiyin	PRP
nahi	NN
nahkoda	NN
naif	JJ
naik	RB
najam	NN
najis	JJ
nakal	NN
nakhoda	NN
nalam	IN
nalar	NN
nali	NN
naluri	NN
naluriah	JJ
nampan	NN
namun	RB
nan	IN
nanah	NN
nanap	VBN
nanas	NN
nandu	NN
nangka	NN
nangui	NN
nanti	RB
napas	NN
naqal	NN
narapidana	NNS
narasi	NN
narasumber	NNS
naratif	JJ
narator	NN
narkolepsi	NN
narkose	NN
narkotik	NN
narsis	JJ
narsisisme	NN
narwastu	NN
nas	IN
nasabah	NNS
nasehat	NN
nasel	NN
nasib	NN
nasihat	NN
nasion	NN
nasional	JJ
nasionalis	NN
nasionalisasi	NN
nasionalisme	NN
nasionalistis	JJ
nasionisme	NN
naskah	NN
nasofaring	NN
nasrani	NN
nasti	NN
nativis	JJ
nativisme	NN
natrium	NN
natur	NN
natura	NN
naturalis	JJ
naturalisasi	NN
naturalisme	NN
nautik	JJ
navigasi	NN
nawa	NN
nawala	VBN
patra	JJ
naziisme	NN
nazir	NN
ndoro	NN
neala	NN
nealogi	PRP$
necis	NNS
nefrektomi	NN
nefritis	NN
nefron	NN
negara	NN
negarawan	NN
negasi	NN
negativisme	NN
neger	NN
negosi	IN
negosiasi	NN
negosiator	NN
negrito	NN
nek	NN
neka	VB
nekad	RB
nekat	NN
neko	NN
nekrofagus	JJ
nekrofili	JJ
nekrofilia	NNS
nekrogeografi	NN
nekrolog	JJ
nekrologi	NNS
nekropolis	NNS
nekropsi	NN
nekrosis	NN
neksus	DT
nelangsa	VBG
nelayan	NN
nemagon	IN
nenda	VB
nendatan	JJ
nenek	NN
nenenda	NN
nener	JJ
nenes	NNS
neng	NN
neofeodalistis	NN
neoimpresionisme	NN
neokarpi	NN
neoklasik	JJ
neoklasisme	NN
neokolonialisme	NN
neoliberalisme	NN
neolit	NN
neolitik	JJ
neologisme	NNS
neonatus	NNS
neoplasma	NN
neoprena	NN
nepotis	NN
nepotisme	NN
neptunus	NN
neraca	NN
nerak	NN
neraka	NN
nervasi	JJ
nervur	NN
nestapa	NN
neto	NN
netral	JJ
netralis	NN
netralisasi	NN
netralisme	NN
netralitas	NN
neurolinguistik	NN
neurolog	NN
neurologi	NN
neurologis	JJ
neurotransmiter	NNS
ngaben	NN
ngalau	NN
ngarai	NN
ngebut	VBG
ngengat	NN
ngeri	JJ
ngilu	NN
ngoko	IN
niaga	NN
nian	JJ
niasin	NN
niat	NN
nidera	TO
nifak	NN
nifas	NN
nih	RB
nihil	NN
nihilisme	NN
nijas	NN
nik	NN
nikah	NN
nikel	NN
nikmat	NNS
nikotin	NN
nila	PRP
nilai	NN
nilam	NN
nilon	NN
nimbrung	NN
nimfomania	NN
ning	CC
ningnong	RB
ningrat	JJ
nini	WP
nirgesekan	NN
nirkabel	NN
nirlaba	JJ
nirselera	NN
nisan	NN
nisbah	NN
nisbi	NN
niscaya	RB
niskala	NN
nista	NN
nistagmus	NN
nitrat	NN
nitrobenzena	NN
noktah	NN
nokturia	NNS
nokturnal	JJ
nol	NN
nomenklatur	NN
nomina	NN
nominalisme	NN
nominasi	NNS
nominatif	JJ
nomine	NN
nomokrasi	NN
nomor	NN
nonaktif	JJ
nondepartemen	JJ
noneksakta	JJ
nonfiksi	NN
nongol	VBG
nonkombatan	JJ
nonkonvensional	JJ
nonmedis	JJ
nonmigas	NN
nonmiliter	JJ
nonpemerintah	JJ
nonteknis	NN
nontradisional	JJ
nopek	NN
norak	NN
norit	VBG
norma	NN
normalisasi	NN
normatif	JJ
nostrum	PRP$
nota	NN
notariat	JJ
notaris	JJ
notasi	NN
notifikasi	NNS
notula	NN
notulis	NNS
novela	NN
novena	JJ
nrima	VBG
nuansa	NN
nubuat	NN
nudis	NN
nudisme	NN
nugat	NN
nujum	NN
nukleat	NN
nukleolus	NN
nukleoprotein	NN
nukleus	NN
nuklida	RB
nuklir	JJ
numeralia	JJ
numerik	JJ
numeris	DT
numismatika	NNS
nun	RB
nung	WRB
nunsius	NNS
nur	RB
nuraga	NN
nurani	NN
nuri	NN
nuriah	NN
nus	JJ
nusantara	NN
nutasi	NN
nutfah	NN
nutrisi	NN
nutrisionis	NN
nutrisisme	NN
nyak	NN
nyalang	NN
nyale	NN
nyali	NNS
nyaman	JJ
nyamuk	NN
nyamur	NN
nyana	NN
nyanya	NN
nyanyang	IN
nyanyi	VBG
nyanyuk	NN
nyarang	VBG
nyarik	NN
nyaring	NN
nyaris	RB
nyata	JJ
nyatuh	VBD
nyawa	NNS
nyawang	NN
nyelekit	NN
nyentrik	NN
nyenyak	RB
nyenyat	NN
nyenyep	NN
nyeri	NN
nyi	IN
nyinyir	NN
nyiri	DT
nyit	JJ
nyonya	NN
nyonyeh	NN
nyunyut	NN
oase	NNS
obat	NN
obeng	NN
obesitas	NN
objek	NN
objektif	NN
objektivitas	NN
oblak	NN
oblasi	DT
obligasi	NN
obor	NN
obral	NN
obras	NNS
obrol	DT
obrus	NN
observasi	NN
observatorium	NN
obsesi	NN
obsesif	JJ
obsolet	IN
obstetri	NNS
obstruksi	NN
obyek	NN
obyektif	NN
obyektivisme	NN
obyektivitas	NN
oceh	JJ
odalan	NN
odoh	NN
odol	NN
odontologi	NN
ofensif	JJ
oferte	NNS
ofisial	NN
ofset	NN
oftalmia	NN
ogah	JJ
ogonium	NN
oja	NN
ojek	NN
oke	NN
oker	JJ
oklokrasi	NN
oklusi	NN
oklusif	JJ
oknum	NN
okok	NNS
oksalat	NN
oksiasetilena	NN
oksida	NN
oksidan	NNS
oksidasi	NN
oksidator	VBG
oksigen	NN
oksigenase	NN
oksimoron	NN
oksiton	NN
oktaf	NN
oktana	NN
oktet	NN
oktober	NN
okulasi	VBG
okuler	NN
okultisme	NN
okupasi	NN
okupasional	JJ
olah	IN
tubuh	NN
olahraga	NNS
olahragawan	NN
olanda	NNS
oleh	IN
olek	NN
oleng	NN
olet	VBP
oli	VBD
oligarki	NN
oligopoli	NN
oligosen	NN
olimpiade	NN
olivin	NN
olok	NN
om	IN
oma	PRP$
ombak	NNS
omong	RB
ompong	NN
omset	NN
omzet	NN
onak	JJ
onani	NN
onder	IN
onderdil	NN
onderdistrik	NN
onderneming	NN
ondo	RB
ondok	NNS
ongji	NN
ongkok	NN
ongkos	NN
oniks	IN
onkologi	NN
onomastika	NNS
onomatologi	NNS
ons	PRP
ontologi	NN
ontologis	RB
onyot	NN
opak	JJ
opas	NN
opasitas	NN
operasi	NN
operasional	JJ
operasionalisasi	NN
operatif	JJ
operet	NN
operkulum	NN
opini	NN
oplah	NN
oplet	NN
oplos	NN
opname	VBG
oponen	NN
opor	NN
oportunis	NN
oportunisme	NN
oportunistis	NN
oportunitas	NN
oposisi	NN
opsen	NN
opsi	NN
opsional	JJ
opsir	NN
optik	NNS
optika	JJ
optimis	JJ
optimisme	NN
optimistis	JJ
optis	JJ
optoelektronika	NNS
optometri	NN
orak	NN
orakel	NN
oralit	NN
orang	NN
oranye	NN
orasi	NN
oratoria	NN
oratoris	NN
oratorium	NN
orbita	NN
orde	NN
ordi	NN
ordinat	NNS
ordiner	JJ
ordner	NN
ordo	NN
ordonans	NN
ordonansi	NN
oreng	JJ
oret	NNS
organdi	NN
organel	NN
organik	JJ
organisasi	NN
organisator	NN
organisatoris	JJ
organisme	NN
organismus	NN
orgasme	NN
orgasmik	JJ
orgel	NN
orientasi	NN
orisinal	JJ
orisinalitas	NN
orkes	NN
orkestra	NN
orkestrasi	NN
ornamen	NNS
ornitologi	NN
ornitosis	NN
orografi	NN
orok	NN
ortodoks	NN
ortodoksi	NN
ortoepi	NN
ortografi	NN
ortografis	VBG
ortopedi	NNS
ose	CC
oseanografi	NN
oseanologi	NN
osilasi	NN
osilator	NN
osiloskop	NN
oskulum	NN
osmose	NN
osteoblas	NN
osteoklas	NNS
osteopati	NN
ostium	NN
otak	NN
otentik	JJ
oto	NN
otobus	NN
otomat	NN
otomatis	JJ
otomatisasi	NN
otomobil	NN
otomotif	JJ
otonom	JJ
otonomi	NN
otorisasi	NN
otoritas	NN
otoriter	JJ
otoritet	NN
otot	NN
ototipi	NN
ovarium	JJ
overal	RB
overdosis	NN
overste	JJ
ovulasi	NN
ovulum	NN
oyak	NN
ozon	NN
pabean	NNS
pabrik	NN
pabrikan	NN
pabrikasi	NN
pacangan	NN
pacar	NN
pacau	NNS
paceklik	NN
pacik	NN
pacok	NN
pacu	NN
pacul	NN
pada	IN
padah	VB
padahal	RB
padak	IN
padam	IN
padan	NN
padang	NN
padas	DT
padat	JJ
padepokan	NN
padi	NN
padri	NNS
padu	JJ
paduk	VBN
paduka	NN
paganisme	NN
pagar	NN
pagas	PRP
pagelaran	NNS
pagi	NN
pagina	NN
pagu	NN
pagun	VBZ
pagupon	NN
pagut	NN
paguyuban	NN
pah	NN
paha	NN
pahala	NN
paham	NN
pahar	NN
pahat	NN
pahit	NN
pahlawan	NN
pahter	JJR
pai	NN
pailit	NN
pais	NNS
paitua	NN
paja	NN
pajak	NN
pajan	NN
pajang	NN
pajuan	NN
pajuh	NN
pak	RB
pakai	NN
pakan	NN
pakansi	NN
pakar	NN
pakaryan	NN
pakau	NNS
pakcik	NN
pakde	NN
pakem	NN
paket	NN
pakihi	NN
pakis	NN
pakpui	NN
paksa	NN
paksi	NNS
paksina	NN
pakta	NN
pakter	NNS
paku	IN
pakuk	NN
pakus	NN
palai	NNS
palaka	NN
palam	RB
palamarta	NN
palang	NN
palas	NNS
palat	NN
palatum	NN
paldu	NN
palem	NN
palen	NNS
paleolitik	JJ
paleolitikum	JJ
paleontologi	NN
palet	NN
paliatif	NN
palindrom	NN
paling	JJS
palinologi	NN
palis	NN
palka	NN
palmitat	NN
palolo	NN
palpasi	NN
palsu	JJ
palu	NN
palun	NN
palung	NN
pamah	JJ
paman	NN
pameget	NN
pamer	NN
pamflet	NN
pamit	NN
praja	NN
pamungkas	RB
pana	IN
panah	NN
panai	PRP
panakawan	NN
panas	JJ
pancacita	NN
pancadarma	NN
pancaka	NN
pancakara	NNS
pancalogam	NN
pancang	NN
pancar	NN
terus	NN
pancaragam	NN
pancaroba	NN
pancasilais	NN
pancawarna	RB
pancawarsa	IN
panci	NN
pancing	NN
pancung	VBN
pancur	NN
pancut	DT
pandai	NN
pandam	JJ
pandan	IN
pandang	NN
pandawa	NN
pandemi	NN
pandemik	NN
pandialektal	NN
pandir	JJ
pandu	NN
panekuk	NN
panelis	NN
panen	NN
pangan	NN
pangeran	NN
panggak	NN
panggal	NN
panggang	VBN
panggar	NN
panggih	NN
panggil	NN
panggon	NN
panggu	NN
panggul	NN
panggung	NN
pangkah	NN
pangkai	NN
pangkal	NN
pangkas	NN
pangkat	NN
pangkin	NN
pangkon	NN
pangku	NNS
pangkung	JJ
pangkur	NNS
panglima	NN
pangonan	NN
pangrukti	NN
pangsa	NN
pangsi	NN
pangsit	NNS
pangus	NN
panik	NN
paniki	NN
panil	NN
paninggil	VBN
paningset	NN
paniradia	NN
panitera	NNS
panitia	NN
panjang	RB
panjar	NN
panjat	VBG
panji	NN
panjut	JJ
pankreas	NNS
pankromatis	NNS
pankronis	NNS
panlektal	NN
panoptikum	NNS
panser	NN
pantai	NN
pantalon	NNS
pantang	NN
pantar	NN
pantas	NN
pantat	NN
pantau	NN
pantekosta	NNS
panter	NN
panti	NN
pantis	NN
pantograf	NN
pantomim	NN
pantri	NN
pantul	NN
panus	DT
panutan	NN
papak	NN
papan	NN
papar	NN
papras	NN
papui	NN
par	IN
para	IN
parabel	NN
paradam	NN
paradigma	NN
paradoks	NN
paradoksal	JJ
parados	JJ
paraf	NNS
parafasia	NN
parafemia	NN
parafrasa	NNS
parafrenia	NN
paragraf	NN
parah	JJ
paralel	NN
paralelisme	NN
paralisis	NN
paramedis	NNS
paramiliter	JJ
paran	NN
parapati	NN
parapsikologi	DT
paras	JJS
parasetamol	NN
parasit	NN
parasitisme	NN
parasut	NN
paratiroid	NN
parau	NN
pare	VBZ
parenkim	NN
parestesia	NN
parfum	NN
pari	JJ
paria	NN
parih	NN
paripurna	JJ
parit	NN
paritas	NN
pariwara	NN
pariwisata	NN
parket	NN
parkir	NN
parkit	NN
parlemen	NN
parlementaria	NNS
parlementarisme	NN
parlementer	JJ
paroki	NN
parokial	NN
parokialisme	NN
parolfaktori	NN
paronomasia	NN
parsial	JJ
partai	NN
partikel	NN
partikelir	NNS
partisi	NN
partisipan	NNS
partisipasi	NN
partitif	NN
partitur	NN
partus	NN
paru	NNS
paruh	NN
parut	NN
parvenu	VBN
pas	RB
pasah	NN
pasak	VBG
pasal	NN
pasang	NN
pasanggiri	NN
pasar	NN
pasara	PRP
pasaraya	NN
pasase	NN
pasasir	NN
pasat	VBN
pascakawin	NN
pascakrisis	NN
pascaoperasi	RB
pascapanen	NN
pascaperang	NN
pascaproduksi	NN
pascareformasi	NN
pascasarjana	NN
pasfoto	NN
pasi	IN
pasien	NN
pasif	NN
pasifikasi	NN
pasifisme	NN
pasigrafi	VBG
pasilan	NN
pasim	PRP$
pasimologi	NN
pasir	NN
pasit	NN
pasiva	NN
paskah	NN
pasok	NN
pasowan	NNS
paspor	NN
pasrah	NN
pasteurisasi	NN
pasti	RB
pastura	NN
pasu	NNS
patah	NN
patang	CD
patela	NN
paten	NN
pater	NN
patera	NN
paternalisme	NN
patet	JJ
pati	PRP
patik	NNS
patka	NN
patogen	NNS
patogenesis	NN
patogenik	NN
patokimia	NN
patolog	NN
patologi	NN
patologis	JJ
patos	NNS
patri	TO
patriark	NN
patriarkat	NN
patrimonium	NN
patriotik	JJ
patriotisme	NN
patroli	NN
patrun	NN
patuh	NN
patung	NN
patungan	NN
patut	NN
pauh	NN
pauhi	JJ
pauk	NN
paun	NN
paus	NN
paviliun	NN
pawai	NN
pawang	DT
pawiyatan	NN
paya	NN
payah	JJ
payau	NN
payudara	NN
payung	NN
pe	IN
peang	NNS
pecah	NN
pecak	NN
pecara	MD
pecat	VBN
pece	NN
pecicilan	NN
pecinan	NN
pecok	NN
pecuk	NN
pecut	NN
pedada	NN
pedadah	NN
pedagog	NN
pedagogi	NNS
pedagogis	JJ
pedak	NN
pedaka	NN
pedang	NN
pedapa	NN
pedar	NN
pedas	NN
pedati	DT
pedel	NN
pedendang	NN
pedengan	NN
pedet	NN
pedewakan	NNS
pediatri	NNS
pedih	NN
pedikur	NN
pedok	NN
pedoman	NNS
peduli	NN
pedusi	NN
pedut	DT
pegal	NN
pegan	NN
pegang	NN
pegar	VB
pegari	NN
pegat	NN
pego	NN
pegoh	NN
pegun	RB
pei	NN
pejal	JJ
pejam	NN
pejatian	NN
pejera	NN
pek	RB
peka	NN
pekak	NN
pekakak	NN
pekan	NN
pekarang	NN
pekasam	NN
pekat	VBN
pekatu	VBN
pekau	NN
pekerti	NN
pekik	NN
pekis	VBN
pekiwan	NNS
pektik	PRP
pektin	NN
peku	NN
pekung	NN
pelagis	NN
pelak	DT
pelampang	NN
pelan	RB
pelana	NN
pelanduk	DT
pelangai	NNS
pelanggi	NNS
pelangi	NN
pelangkin	NN
pelas	IN
pelasuh	NNS
pelat	NN
pelata	NN
pelatuk	NN
pelbagai	JJ
pelebat	NN
pelebaya	NN
pelebegu	NN
pelebon	NN
peleh	NN
pelek	NN
pelekat	NN
pelepah	NN
peles	NN
pelesat	PRP$
pelesir	NN
pelet	NNS
peletik	NN
pelihara	VB
pelik	NN
pelintir	NN
pelipir	NN
pelipis	NN
pelit	NNS
pelita	NNS
pelo	NN
pelopor	NN
pelor	NN
pelosok	NNS
pelosot	NN
pelota	NN
pelpolisi	NNS
pels	IN
peluh	NN
peluit	NN
peluk	NN
pelumpung	NN
pelupuk	NN
peluru	NN
pelus	NN
pematang	NNS
pembayan	NNS
pemendak	NN
pemeo	NN
pemidang	NN
pemudi	NN
pemuras	NN
pena	NN
penak	NN
penalti	NN
penampan	NN
penasaran	JJ
penat	VBN
penatu	NN
penatua	NNS
pencar	NN
pencet	NN
pencok	NN
pencu	VBG
pencut	NN
pendahan	NN
pendak	NN
pendar	NN
pendaringan	VBG
pendek	JJ
pendet	NN
pendeta	NN
pendongkok	VBG
penembahan	NN
penes	RB
penetrasi	NN
penewu	DT
penganan	NN
pengantin	DT
pengap	NN
pengapuh	NN
pengar	NN
pengaruh	NN
pengatu	NN
pengerih	NN
pengga	NN
penggaga	DT
penggal	NN
penggar	NN
penghulu	DT
pengkal	NN
pengkar	NN
pengkis	DT
pengkor	DT
pengulun	NNS
pening	NN
penisilin	NN
peniti	NN
penjajap	NN
penjara	NN
penjaruman	VBG
penologi	NN
penomah	NN
pensi	NN
pensil	NN
pensiun	NN
pentan	NN
pentana	NN
pentang	NN
pentas	NN
pentatonik	NN
pentil	NN
penting	JJ
pentol	NN
pentung	NN
penuh	JJ
penyap	VBG
penyek	NN
penyok	NN
penyu	NN
peot	NN
pepak	JJ
peparu	NNS
pepas	NNS
pepat	NN
pepatah	DT
pepaya	NN
peper	NN
pepes	NNS
peptida	NNS
peptik	JJ
pepuju	NN
pepung	NN
pera	NN
perabot	NN
perada	DT
peragat	JJ
peragawati	NN
perah	NN
perahu	NN
perak	NN
peraka	IN
peram	NN
peran	NN
perang	NN
perangah	NN
perangai	NN
peranggang	NN
peranggu	NN
perangin	NN
peranjat	NN
peranti	NN
peranye	DT
perap	NN
peras	NNS
perasat	NN
perasukan	NN
perat	NN
perawan	NN
perawis	NN
perban	NN
perbani	NNS
perbawa	NN
perbekel	NN
perca	NN
percaya	VB
percis	NN
percul	NN
perdah	VBG
perdana	NN
perdata	JJ
perdeo	NN
perdu	VBN
pereh	NN
perei	TO
perempuan	NNS
perenggan	NN
perengkat	NN
perenial	NN
peretel	NN
perewa	NN
perfek	NN
perfeksionis	NN
perfeksionisme	NN
perforasi	NN
performa	NN
pergam	NN
pergi	VB
pergok	NN
pergol	NN
peria	NN
periang	NN
peribahasa	NN
perifer	JJ
periferal	NNS
periferi	NN
perigi	RB
perih	NN
perihal	NN
perikarditis	NN
perikardium	NN
perikemanusiaan	JJ
periksa	NN
perilaku	NN
perin	RB
perinci	NN
perincit	NN
peringgi	NNS
peringkat	NNS
perintah	NN
periode	NN
periodik	NN
periodisasi	NN
periorbita	NN
perisa	NNS
perisai	NN
peristaltik	JJ
peristerit	NN
peristiwa	NN
periuk	NN
perjaka	NN
perkakas	VBG
perkamen	NN
perkara	NNS
perkasa	NN
perkedel	NNS
perkelang	NN
perkolar	NN
perkolasi	NNS
perkolator	NN
perkoler	NN
perkosa	NN
perkusi	NN
perkutut	NN
perlahan	RB
perlak	VB
perlambang	NN
perlente	NN
perlenteh	NN
perlina	NN
perlit	NN
perlu	NN
perlus	NNS
permadani	NNS
permai	NN
permaisuri	NN
permak	NN
permana	NN
permanen	NN
permanganat	NN
permata	NNS
permeabel	JJ
permeabilitas	NN
permen	NN
permisi	NN
permisif	NN
permutasi	NN
pernah	RB
pernik	NNS
perogol	NN
perohong	NN
peroi	NN
peroksidase	NN
peroksisom	NN
perosok	NN
perosot	NN
persada	NN
persangga	NN
persekot	VBN
persekusi	NN
persen	NN
persentase	NN
persentil	NN
persepsi	NN
perseptif	NN
perseptivitas	NN
persih	RB
persik	NN
persil	NN
persis	RB
perslah	NN
persneling	NN
persona	NN
personalisme	NN
personalitas	NN
personel	NN
personifikasi	NN
perspektif	NN
persuasi	NN
persuasif	NN
pertama	RB
pertiwi	NN
pertua	RB
pertusis	NN
peruan	JJ
peruk	NN
perumpung	NN
perunggu	NN
perupuk	NNS
perus	JJ
perusi	NNS
perut	NN
perversi	NN
perwira	NN
pesa	NNS
pesak	NN
pesam	NN
pesan	NN
pesara	NN
pesat	NN
pesawat	NN
pesek	NN
peser	TO
peset	PRP
pesi	NNS
pesimis	NN
pesimisme	NN
pesimistis	JJ
pesisir	NN
pesona	NN
pesta	NN
pora	DT
pestisida	NN
pestol	NN
pesuk	NN
pesut	NNS
peta	NN
petak	NN
petaka	NN
petam	NN
petang	NN
petaruan	NNS
petas	NN
petatus	NNS
petek	NN
peterana	DT
peterseli	NN
peti	NN
petik	NN
petir	VBG
petis	NN
petisi	NN
petisiwan	NN
petitum	VBN
petor	NN
petrokimia	NNS
petuah	NN
petuduh	DT
pewat	NN
peyek	NN
piagam	NN
piak	JJ
piala	NN
pialang	NNS
pianggang	NN
pianggu	VBN
pianis	NN
piantan	NN
piarit	NN
piatu	NNS
piawai	NN
pica	VBG
picik	NNS
picit	DT
picu	NN
pidana	JJ
pidato	NN
pidi	VBD
piezoelektrik	NN
pigmen	NN
pigmentasi	NN
pigmi	NN
pigura	NNS
pihak	NN
pijah	NN
pijak	NN
pijar	NN
pijat	NN
pijit	NN
pika	RB
pikap	NN
pikat	NNS
pikau	PRP
piket	NNS
pikir	NN
piknik	NN
piktografi	NN
pikul	RB
pikun	NN
pil	NN
pilak	NN
pilas	NNS
pilek	NN
pilih	NN
pilin	NN
pilis	NN
pilong	NN
pilorus	NNS
pilu	NN
pimpin	NN
pinak	JJS
pincang	NN
pincuk	JJ
pinda	DT
pindah	NN
pindai	NN
pinga	VBG
pinggah	DT
pinggan	NNS
pinggir	NN
pinggul	NN
pingit	NNS
pingkal	NN
pingkau	IN
pingsan	VBN
pingul	NN
pinis	NN
pinjam	NN
pinset	NNS
pinta	NN
pintal	NN
pintan	NN
pintar	NN
pintas	NNS
pintil	NN
pintu	NN
piogenik	NN
pioner	NN
pionir	NN
pipa	NN
pipi	NN
pipih	JJ
pipis	NN
pir	DT
piramida	NN
piramidal	NN
pirang	NN
pirau	NN
pirektik	NN
piring	NN
pirofobia	NN
pirolisis	NN
piromania	NN
pirsa	DT
pisah	JJ
pisang	NN
pisau	NN
pisik	JJ
pistom	NN
pisuh	NN
pitam	NN
pitar	NN
piting	VBG
piuh	VBN
piutang	NNS
piwulang	NN
piza	NN
plafon	NN
plagiarisme	NN
plagiat	NN
plagiator	NN
plakat	NN
plaket	NN
plang	NN
plangkan	VBG
planimetri	NNS
planologi	NN
planospora	NNS
plantase	NN
plasenta	NN
plaser	NN
plastik	NN
plastis	NN
plastisitas	NN
plastometer	NN
platina	NN
platonik	NN
platonisme	NN
pleiogami	JJ
pleksus	NN
pleno	JJ
plerem	NN
plester	NN
pletora	NNS
plintit	TO
pliosaurus	NN
pliosen	NN
ploi	NN
ploidi	NN
plombir	NN
plonco	NN
plumbum	NN
pluralis	NN
pluralisme	NN
pneumatika	NN
poci	VBG
pocok	NN
podemporem	MD
poetika	JJ
pohon	NN
poin	NNS
pojok	NN
poket	NNS
poko	RB
pokok	NN
pokrol	NN
pola	IN
polah	NN
polan	NNS
polang	NN
polarimetri	NNS
polarisasi	NN
polaritas	NN
polemik	NN
polen	NN
polenter	NN
poler	NNS
poliandri	NN
poliester	NN
polifagia	NN
polifase	NN
poligam	NN
poligami	NN
poligini	NN
poliglot	NN
poligraf	NN
poliklinik	NN
polimer	NN
polimerisasi	NN
polip	NN
polipeptida	NN
polipropilena	NN
polis	NNS
polisakarida	NNS
polisemi	NN
polisi	NNS
polisiklis	NN
polisilogisme	NN
polisindeton	NN
polister	DT
politbiro	NN
politeknik	NN
politena	JJ
politik	JJ
politikus	NN
politis	JJ
politisasi	NN
poliuretan	NN
polong	NN
polusi	NN
polutan	NN
poma	NN
pompa	NN
pompang	NN
ponakan	NN
ponco	NN
pondik	VBN
pondok	NN
pondong	NN
ponggang	NN
poni	NN
ponor	NN
pontoh	NNS
ponton	NN
popi	NNS
popok	NN
popor	NNS
popularitas	NN
populasi	NN
populer	JJ
populisme	NN
porah	NN
porfiria	NNS
pori	NN
pornografi	NN
porok	NN
porong	NN
poros	NNS
porositas	NN
porot	NN
porselen	NN
porsi	NN
porta	NN
portabel	JJ
portepel	NN
portik	NN
portofolio	NN
poser	TO
posesif	NN
posisi	NN
positivisme	NN
postar	NN
postulat	NN
postur	NN
potas	NN
potasium	NN
potator	NN
potensi	NN
potensial	JJ
potensiometer	NN
potia	PRP
potlot	NN
potong	NN
potret	NN
praanggapan	NN
praba	DT
pradini	JJ
praduga	NN
pragmatik	JJ
pragmatika	NNS
pragmatis	JJ
pragmatisme	NN
prah	NN
prahara	NN
prajurit	NN
prakarsa	NN
prakarya	DT
prakata	NN
prakira	NN
prakondisi	NNS
prakonsepsi	NN
praksis	NN
praktik	NN
praktikan	IN
praktikum	NN
praktis	JJ
praktisi	NNS
pramugara	NN
pramugari	NN
pramuka	NN
pramuniaga	NN
pramupintu	VBN
pramusaji	NN
pramutamu	NN
pramuwisata	NNS
pramuwisma	NN
pranala	NNS
pranata	NNS
pranatacara	NN
prangko	NNS
pranikah	NN
prapendapat	NN
praperadilan	JJ
prapubertas	VBN
prapuna	NN
prarasa	NNS
prarekam	NN
praremaja	NNS
prasaja	NN
prasangka	NN
prasarana	NN
prasasti	NN
prasejahtera	JJ
prasejarah	NN
prasekolah	NN
prasetia	NN
prasi	PRP
prasmanan	NN
prasyarat	NN
pratersier	VBG
pratinjau	NN
prawacana	NN
prayitna	NN
preambul	JJ
preasetabulum	NN
predasi	NN
predikat	NN
predikatif	NN
prediksi	NN
predisposisi	VBG
preferensi	NN
prefiks	NN
prei	NN
prekursor	NNS
preman	NNS
prematur	NN
premi	NNS
premis	NNS
preparat	NN
preposisi	NN
prerogatif	NN
presbiopia	NN
preseden	NN
presensi	NN
presentabel	JJ
presentasi	NN
preservasi	NN
presesi	NN
presiden	NN
presidensial	JJ
presiositas	NNS
presipitasi	NN
presisi	NN
preskripsi	NN
preskriptif	NN
prestasi	NN
prestise	NN
prestisius	JJ
pretel	NN
pretensi	NN
prevalensi	NN
preventif	NN
prewangan	NN
pria	NN
priayi	NN
pribadi	JJ
pribumi	JJ
prihatin	JJ
prima	IN
primadona	NN
primas	NNS
primata	NNS
primitif	NN
primogenetur	NN
primordialisme	NN
prinsip	NN
prinsipiil	NN
prioritas	NN
pripih	NN
pris	NN
prisma	NN
prit	VBD
privasi	NN
privat	JJ
privatisasi	NN
forma	NN
proaktif	NN
problematik	NN
prodemokrasi	NN
produk	NN
produksi	NN
produktif	JJ
produktivitas	NN
produsen	NN
produser	NN
profan	NN
profesi	NN
profesional	JJ
profesionalisme	NN
profesionalitas	NN
profesor	NN
profetik	NN
profil	NN
profilaksis	NN
profitabel	JJ
profitabilitas	NN
progesteron	NN
programa	NN
progres	NN
progresif	NN
proklamasi	NN
proklamator	NN
proksimal	NN
proksimat	VB
prokurator	NN
prolat	NN
proletar	JJ
proliferasi	NN
promontorium	NN
promosi	NN
promotif	NN
promotor	NN
promovendus	NN
pronomina	NNS
propagandis	NN
propana	NN
propelan	NN
propeler	NN
properti	NN
propilena	NN
proporsi	NN
proporsional	NN
proposisi	NN
propulsi	NN
prosa	NN
prosede	NNS
prosedur	NN
prosedural	JJ
proses	NN
prosesi	NN
prosesor	NN
prospek	NNS
prospektif	JJ
prospektus	NN
prostat	NN
prostitusi	NN
protagonis	NN
protaktinium	NN
proteksi	NN
proteksionisme	NN
protektif	NN
protektorat	NN
proteolitik	JJ
protes	NN
protese	NN
protesis	NN
protestan	NN
protestantisme	NN
protokoler	NN
protoplasma	NN
prototipe	NN
protrombin	NN
provinsi	NN
provisi	NN
provokasi	NN
provokatif	NN
provokator	NN
provos	NN
proyek	NN
proyeksi	NN
proyektil	NN
proyektor	NN
prudensial	NN
pseudonim	NN
psikiater	NN
psikiatri	NN
psikis	JJ
psikoanalisis	NN
psikodrama	NN
psikofarmakologi	NN
psikofisiologis	NN
psikolepsi	NN
psikolinguistik	NNS
psikolog	NN
psikologi	NN
psikologis	JJ
psikometri	NN
psikometrika	NNS
psikomotor	NN
psikomotorik	NN
psikoneurosis	NN
psikopat	NN
psikopati	NN
psikopatologi	NN
psikosastra	NN
psikoseksual	JJ
psikosis	NN
psikosomatik	JJ
psikoteknik	NN
psikoteknis	JJ
psikoterapi	NN
psikotes	NN
psikotropika	NN
psikrometri	NNS
puadai	NN
puak	NN
pualam	NN
puan	NN
puas	JJ
puasa	VBG
puber	NN
pubertas	NN
publik	NN
publikasi	NN
publisistik	NN
publisitas	NN
pucat	NN
pucuk	NNS
pucung	VBN
pudar	VBD
pudel	NN
puder	MD
puding	VBG
pudur	NN
puerpera	NN
pugak	NN
pugas	VBG
puguh	NN
puing	NN
puisi	NN
puitis	JJ
pujangga	NN
puji	NN
pujuk	NN
pukah	MD
pukal	NN
pukas	NN
pukat	NN
puki	NN
pukul	NN
pul	NN
pula	JJ
pulan	NN
pulang	NN
pulas	NN
pulau	NN
pulih	VBN
pulik	NN
pulover	NN
pulpen	VB
pulsa	NN
pulsasi	VBG
puluh	NNS
pulun	PRP$
pulung	VBG
pulut	JJ
pumpun	NN
pun	RB
punah	NN
punakawan	NN
punca	NN
puncak	NN
punci	NN
pundak	NN
punduk	NN
pundung	MD
pung	NN
punggah	NN
punggai	JJ
punggal	JJ
punggung	RB
pungkas	VBD
pungkur	RB
pungli	NN
pungsi	NN
pungtuasi	JJ
punguk	NN
pungut	NN
punia	NN
puntal	NN
punti	NNS
puntianak	NN
puntir	NN
puntuk	NNS
puntul	IN
puntung	NN
punuk	NN
punya	VB
pupu	NN
pupuk	NN
pupur	NN
pupus	NNS
pura	NN
purba	NN
purbakala	NN
purbasangka	NN
purifikasi	NN
purisme	NN
puritanisme	NN
purnajual	NN
purnama	JJ
purnawaktu	JJ
purnawirawan	VBN
puruk	NN
purun	NN
purus	NN
purut	NN
purwakanti	NN
purwarupa	NN
pusaka	NN
pusar	NN
pusara	NN
pusat	NN
pusing	NN
puso	NN
puspas	NNS
pusta	JJ
pustaka	NN
pustakawan	JJ
pusu	NN
pusung	NN
pusut	NNS
putar	NN
putat	NN
tulang	NN
putik	NN
putra	NN
putri	NN
putu	NN
mayang	NN
putus	NN
putut	MD
puyonghai	NN
puyuh	NN
qaf	NN
qari	NN
qi	NN
qiraah	NN
raba	NN
rabana	VBZ
rabas	NN
rabi	NN
rabiulakhir	JJ
rabotase	PRP
rabuk	NNS
rabun	NN
rabung	NN
rabut	NN
racun	NN
rad	NN
rada	VBG
radah	MD
radai	NN
radang	NN
radas	NN
raden	TO
rades	NN
radi	NNS
radiasi	NN
radikal	JJ
radikalisasi	NN
radikalisme	NN
radiks	NNS
radikula	JJ
radioaktif	NN
radioaktivitas	NN
radiograf	NN
radiografi	NN
radioisotop	NN
radiokarbon	NN
radiolog	NN
radiologi	NN
radiotelefoni	NN
radioterapi	NN
radis	PRP
radu	NN
radurisasi	NN
rafaksi	DT
rafia	NN
raga	NN
ragang	NN
ragas	NN
ragawi	JJ
ragi	NN
ragu	NN
raguk	NN
ragum	IN
ragung	NN
ragut	NN
rahang	NN
rahasia	NN
rahat	JJ
rahib	NN
rahmat	NN
rahu	NN
raib	VBD
raih	VB
rais	NN
rajam	VBG
rajapati	NN
rajawali	NN
rajin	NN
rajok	NNS
rajungan	NN
rajut	VBG
raka	NN
rakanita	NN
rakap	VB
rakat	NN
rakawira	VBD
rakbol	NN
raket	NN
rakit	NN
rakna	NN
raksa	NN
raksasa	NN
rakuk	NN
rakus	NN
rakyat	NNS
ralat	NN
ramah	RB
ramai	VBN
ramal	NN
rambang	NN
rambat	NN
rambu	NN
rambung	NN
rambut	NN
rambuti	NN
rames	NN
rampa	NN
rampak	JJ
rampang	NN
rampas	NN
rampat	NN
rampok	NN
rampung	VBN
rampus	NN
ramus	NN
ranah	NN
ranap	VBG
rancah	VBN
rancang	NN
rancau	NN
rancu	JJ
randai	NNS
randak	NN
randat	VB
randek	VBG
randu	NN
rang	NN
rangas	NN
rangga	NN
ranggah	NN
ranggas	VBD
ranggul	VBN
ranggung	NNS
rangka	NN
rangkai	NN
rangkak	NN
rangkam	NNS
rangkang	NN
rangkaya	NN
rangkik	NN
rangking	NN
rangkit	VB
rangkul	NN
rangkum	VB
rangkung	NN
rangkup	NN
rangkus	NN
rangkut	NN
rangrangan	NN
rangsang	NN
rangu	NN
rangup	NN
ranjang	NN
ranjau	NN
ranjing	VBG
ransel	NN
rantau	NN
ranti	VB
rantuk	NN
rantus	NN
ranum	NN
rapat	NN
rapel	VBG
rapi	NN
rapiah	NN
rapor	NN
rapsodi	NN
rapu	NN
rapuh	NN
rapun	NN
rapus	NN
raraha	NN
rarai	NN
rarak	NN
rarangan	NNS
raras	NN
rasa	NN
rasai	NN
rasau	NN
rase	NN
rasi	PRP
rasia	NN
rasial	JJ
rasialis	NN
rasialisme	NN
rasian	DT
rasio	NN
rasional	JJ
rasionalis	NN
rasionalisasi	NN
rasionalisme	NN
rasionalitas	NN
rasisme	NN
rasuk	NN
rasul	NN
rasuli	NN
rasyid	NN
ratap	NN
ratifikasi	NN
ratu	NN
ratus	VBN
rau	NNS
raum	NN
raun	RB
raung	NN
raup	NN
raut	NN
rawa	RB
rawak	NN
rawan	NN
rawin	NN
raya	JJ
rayap	NN
rayau	VBG
rayonisasi	NN
rayu	NN
razia	NNS
reagen	NN
reaksi	NN
reaksioner	NN
reaktan	NNS
reaktans	NNS
reaktansi	NN
reaktif	NN
reaktivitas	NN
reaktor	NN
reaktualisasi	NN
realisasi	NN
realisme	NN
realistis	JJ
realitas	NN
realokasi	NN
reasuransi	NN
rebab	NN
rebah	NN
reban	DT
rebana	NN
rebas	NNS
rebat	NN
rebeh	NN
rebet	NN
reboisasi	NN
rebuk	NN
rebung	NN
rebus	NNS
receh	NN
recok	NN
reda	VB
redah	JJ
redaksi	NN
redaksional	NN
redaktur	NN
redam	NN
redik	NN
redoks	NN
reduksi	NN
redup	NN
reduplikasi	NN
redusir	VB
reekspor	NN
referat	NN
referensi	NN
refleks	NN
refleksi	NN
reflektif	NN
reflektor	NN
reformasi	NN
reformis	NN
refraksi	NN
refraktometer	NN
refraktor	NN
refrein	NN
regas	NNS
regat	NN
regata	NN
regel	NN
regenerasi	NN
reges	NNS
regi	NN
regio	NN
regionalisme	NNS
registrasi	NN
reglemen	JJ
reglementer	NNS
regresi	NN
regresif	NN
reguk	NN
regulasi	NN
reguler	JJ
rehabilitasi	NN
rehabilitatif	NN
rehat	NN
rehidrasi	NN
reindoktrinasi	NN
reinkarnasi	NN
reintegrasi	NN
reinterpretasi	NN
reja	JJ
rejan	VBG
rekal	RB
rekalkulasi	NN
rekam	NN
rekan	NNS
rekanalisasi	NN
rekap	NN
rekapitalisasi	NN
rekapitulasi	NN
rekat	NNS
rekata	NN
rekayasa	NN
rekayasawan	NN
reken	NN
rekening	NN
reklamasi	NN
reklame	NN
reklasifikasi	NN
rekombinan	NN
rekombinasi	NN
rekomendasi	NN
rekonsiliasi	NN
rekonstruksi	NN
rekonvensi	NN
rekor	NN
rekreasi	NN
rekrut	NN
rekrutmen	NN
reksa	JJ
rekstok	NN
rektifikasi	NNS
rekto	NN
rektor	NN
rekuiem	NN
rekuisisi	NN
rekurs	NN
rela	JJ
relai	NN
relaks	NN
relaksasi	NN
relang	NN
relas	NNS
relasi	NN
relatif	NN
relativisme	NN
relativitas	NN
relau	NN
relawan	NNS
relban	NN
relevan	NN
relevansi	NN
reli	NN
reliabel	JJ
reliabilitas	NN
religi	NN
religiositas	NN
religius	JJ
relik	NNS
relikui	NNS
relokasi	NN
reluk	NN
relung	NN
remah	NN
remai	NN
remaja	NNS
remanen	NN
remang	NN
remas	NN
rematik	NN
rematisme	NN
rembah	NN
rembas	NN
rembes	VBD
rembet	VBN
rembih	NN
rembuk	NN
rembulan	NN
remburs	NN
remedi	NN
remediasi	NN
remeh	JJ
remenia	NN
remet	NNS
remis	VBN
remisi	NN
rempa	NN
rempah	NNS
rempak	NN
rempenai	NN
rempeyek	NN
rempus	NN
remujung	NN
remuk	JJ
remunerasi	NN
renaisans	NN
renang	NN
rencam	NN
rencana	NN
rencet	NN
renda	NN
rendabel	JJ
rendah	JJ
rendam	NN
rendong	NN
renegosiasi	NN
renek	NN
reng	NN
rengas	NN
rengeh	NN
rengek	VBG
rengeng	JJ
rengga	VB
renggam	NN
renggang	JJ
renggat	NN
renggek	NN
rengges	NNS
renggut	NN
rengkah	NN
rengkam	NN
rengkeh	NN
rengket	NN
rengkuh	NN
rengsa	JJ
rengut	VBN
renik	RB
renjana	NN
renjatan	VBG
renovasi	NN
renta	NN
rentabilitas	NN
rentak	NN
rentan	JJ
rentang	NN
rentap	NN
rentas	NNS
rente	NN
renteng	RB
rentenir	NN
rentet	NN
renti	NN
renung	NN
renvoi	NN
renyah	NN
renyang	NN
renyek	NN
renyuk	VBN
reol	NN
reologi	NNS
reorganisasi	NN
reorientasi	NN
reostat	NN
repang	NN
reparasi	NNS
repas	NN
repatriasi	NN
repek	NN
repertoar	NN
repet	NN
repeten	NN
repetisi	NNS
repetitif	NN
repetitor	NN
repih	NN
replik	NN
replika	NN
repormir	NN
reportase	NN
reposisi	NN
repot	NN
representasi	NN
representatif	NN
represi	NN
represif	NN
reproduksi	NN
reprografi	NN
reptil	NN
reptilia	NN
republik	NN
republiken	NN
repuh	VBN
repui	VBN
reput	NNS
reputasi	NN
rerangka	NN
rerata	JJ
rerongkong	NN
reruntuk	NNS
resa	NN
resah	NN
resam	NN
resan	NN
resek	NN
resensi	NN
resep	NN
resepsi	NN
resepsionis	NN
reseptif	NN
reseptor	NNS
reserse	NN
reservat	VBN
reses	NNS
resesi	NN
resi	NNS
residen	NN
residivis	NNS
residu	NN
resik	NN
resiko	NN
resimen	NN
resipien	NNS
resiprok	VBG
resiprokal	JJ
resistans	NN
resistansi	NN
resmi	JJ
resolusi	NN
resonan	NN
resonansi	NN
resor	NNS
resorpsi	NN
resorsinol	NN
respek	NN
respirasi	NN
responden	NNS
respons	NN
responsif	NN
restan	NN
restitusi	NN
restoran	NN
restorasi	NN
restriksi	NN
restrukturisasi	NN
restu	NN
resultan	NN
resurjensi	NN
reta	NN
retak	VBN
retardasi	NN
retas	NN
retek	NN
retenidos	VBN
retensi	NN
retet	NNS
retih	NN
retok	NN
retorik	NN
retorika	NN
retoris	JJ
retret	VBN
retribusi	NN
retroaktif	JJ
retrogresi	NN
retrospeksi	NN
retur	NN
retus	NN
reumatismos	NNS
reuni	NN
reunifikasi	NN
revaluasi	NN
revisi	NN
revitalisasi	NN
revolusi	NN
revolusioner	JJ
rewak	JJ
rewan	NN
rewang	DT
rewel	NN
reyot	NN
rezeki	NN
rezim	NN
riak	NN
riam	VBN
riang	NN
rias	NN
riba	NN
ribang	NN
ribatat	NN
riben	NN
ribosom	NNS
ribu	NN
ribut	NN
ricau	JJ
ricuh	NN
ridan	IN
ridi	NN
ridu	NNS
riil	JJ
rileks	NN
rilis	NN
rimas	NN
rimata	NN
rimba	NN
rimbas	NN
rimbat	NN
rimbawan	VBG
rimbun	NN
rime	NN
rimis	DT
rimpang	NNS
rimpel	NN
rimpuh	NN
rinai	NN
rincu	RB
rindang	NN
rindu	NN
ringan	NN
ringik	DT
ringis	IN
ringkai	NN
ringkas	NN
ringkih	NN
ringkik	VBD
ringking	VBG
ringkuk	VBN
ringsek	NN
rinitis	NN
rintang	NN
rintas	NN
rintih	NN
rintik	VBN
rintis	VBN
risa	NN
risak	NN
risau	JJ
riset	NN
risi	NN
risik	NN
risiko	NN
risit	NN
riskan	JJ
rit	NN
ritel	JJ
ritme	NN
ritmis	NN
ritul	NN
ritus	NN
riuh	JJ
riuk	NN
rivalitas	NN
riwan	NN
riwayat	NN
robek	NN
roboh	VBN
robok	NN
robotika	NNS
rocet	NN
roda	NNS
rodat	NN
rodok	RB
rogoh	VBN
rogol	NN
roh	NN
rohani	JJ
rohaniah	JJ
rohaniwan	NN
rohmat	NN
roi	NN
rok	NN
rokade	NN
roket	NN
roki	NNS
rokok	NN
rol	NN
rolet	NNS
romanistik	NN
romansa	NN
romantik	JJ
romantika	NN
romantikus	JJ
romantis	JJ
romawi	NN
rombak	NN
rombik	NN
rombok	NN
romok	NNS
rompak	NN
rompes	PRP
rompi	NN
rompok	NN
romsus	NN
romusa	NN
roncet	NN
ronde	NN
rondok	NN
rong	NN
rongak	NN
rongga	NN
rongkoh	CD
rongkok	NNS
rongkol	NN
rongkong	NN
rongos	NN
rongrong	NN
rongseng	NN
rongsok	NN
ronta	NN
rontok	NN
ronyok	NN
rosok	NN
rosot	VBD
rotan	NN
rotasi	NN
roti	NN
royak	NN
royalti	NN
rua	NN
ruam	NN
ruang	NN
ruap	NN
ruas	NNS
ruat	NN
rubah	NN
rubai	NNS
ruban	NN
rubel	NN
rubela	NNS
rubeola	NN
rubing	VBG
rubrik	NN
rubu	NN
rucah	NN
rudal	NNS
rudu	NN
rudus	NN
rugbi	NN
rugi	NN
ruh	NN
ruit	NN
rujah	NN
rujuk	NN
ruku	NN
rukuk	NN
rukun	NN
rumah	NN
sakit	NN
tangga	NNS
rumbah	NN
rumbai	NNS
rumenia	NN
rumin	DT
ruminansia	NNS
rumit	VBN
rumpakan	NN
rumpang	NN
rumpi	VBN
rumpon	NNS
rumpun	NNS
rumput	NN
rumrum	NN
rumung	NN
rumus	NN
runcing	VBN
runcit	JJ
runding	NN
rundung	NN
runggas	NN
runggu	NN
rungguh	NN
rungkau	NN
rungkuh	NN
rungkun	NN
rungkup	NN
rungu	NN
rungut	NN
runjung	NNS
runtai	NN
runtuh	NN
runtut	NN
runut	NN
runyam	NN
ruok	NN
rupa	NN
rupawan	NN
rurut	NN
rusa	JJ
rusak	NN
rusuh	NN
rusuk	JJ
rutab	VBN
rute	NN
rutenium	NN
ruterfordium	NN
rutin	NN
rutup	NN
ruwet	VBN
sa	NN
saadin	NN
saat	NN
saba	CD
sabar	NN
sabat	NN
sabatikal	JJ
sabda	NN
saben	PRP
sabit	JJ
sablon	NN
sabotase	NN
sabsab	NN
sabtu	NN
sabun	NN
sabung	NN
sabut	RB
sadah	NN
sadak	NN
sadang	NN
sadap	VBG
sadar	JJ
sadau	NN
sadel	NN
sadis	JJ
sadisme	NN
sadistis	JJ
sadrah	NN
sadran	NN
saf	NN
safih	NN
sagitarius	NN
sagon	NN
sagu	NN
sagur	NN
sah	NN
sahabat	NN
saham	NN
sahan	NN
sahap	NN
saharah	NN
sahaya	NN
sahi	RB
sahib	NN
sahifah	NN
sahih	JJ
sahkan	NN
sahut	VBD
sailan	IN
sailo	NN
saing	NN
sains	NN
saintis	NN
sair	VB
sais	VB
saja	RB
sajadah	NN
sajang	NN
saji	VBG
sak	NN
sakal	NN
sakar	VBN
sakarida	NNS
sakarosa	NN
sakat	JJ
sakelar	NN
sakhawat	VBG
saking	IN
sakral	VBN
sakramen	NN
sakramentalia	NNS
sakrilegi	NN
sakristi	VB
sakrokoksigeal	NN
sakrum	NN
saksama	RB
saksi	NN
saksofon	NN
sakti	NN
saku	NN
sal	MD
sala	NN
salah	JJ
salaris	NN
saldo	NN
salep	NN
salib	NN
salin	NN
salindia	NN
salindra	NN
saling	DT
salinisasi	NN
salir	VB
salivasi	NN
salju	NN
salto	NN
saluir	NN
salur	NN
salut	NN
salvarsan	VB
salvo	IN
sama	JJ
samad	JJ
saman	RB
samaniah	JJ
samas	IN
samawi	NN
sambal	NN
sambil	IN
sambiloto	NN
sambung	NN
sambur	NN
sambut	NN
sami	RB
samin	NNS
sampah	NN
sampai	TO
sampak	NN
sampakan	TO
sampang	NN
sampanye	NN
sampar	NN
sampean	PRP
sampel	NN
sampeyan	PRP
sampil	VBN
samping	NN
sampir	NN
sampu	NNS
sampul	NN
samseng	NNS
sanad	CD
sanak	NNS
sanat	NN
sanatogen	NN
sanca	NN
sanda	NN
sandang	NN
sandar	NNS
sandera	NN
sandiwara	NN
sandung	VBG
sandungan	VBG
sangai	NN
sangat	RB
sangau	NN
sangga	NN
sanggah	NN
sanggam	NN
sanggama	NN
sanggar	NN
sanggep	VBG
sangging	NN
sanggit	NN
sanggrah	NN
sanggul	NN
sanggup	JJ
sanggurdi	NN
sangih	NNS
sangka	NN
sangkak	NN
sangkakala	NN
sangkal	NN
sangkala	NN
sangkan	MD
sangkar	NN
sangkur	NNS
sangkut	JJ
sangli	NN
sangling	VBG
sangon	NN
sangrai	VBG
sangsi	NN
sangu	NN
sangulun	NN
sanitasi	NN
saniter	JJ
sanjung	VBG
sanksi	NNS
sano	JJ
sanskerta	NN
santai	NN
santan	NN
santap	NN
santet	NN
santun	RB
sapat	RB
sapau	NN
sapersi	VB
sapi	NN
sapih	VBG
sapit	NN
saptadarma	NN
sapu	NN
saput	NNS
saputangan	NN
sar	NN
saraf	NN
sarana	NNS
sarang	JJS
sarasehan	NN
sarat	VBN
sarden	NNS
sarean	NN
sarengat	DT
saring	NN
sarit	NN
sarjana	NN
sarju	DT
sarkasme	NN
sarkastis	JJ
sarkofagus	NN
sarkoma	NN
sarkoplasma	JJ
saru	VBN
sarung	NNS
sarut	NN
sasa	RB
sasakala	NNS
sasap	NN
sasar	NN
sasi	NN
sasian	JJ
sasis	NN
sastra	NN
sastrawan	NN
sastrawi	JJ
satak	RB
satar	NN
satelit	NN
satih	NN
satir	NN
satori	NN
satpam	NN
satu	CD
satwa	NNS
satyawacana	NN
saudagar	NN
saudara	PRP
saudari	NN
sauh	NN
saum	NN
saus	NN
saut	NN
sauvinis	NNS
sawa	NN
sawah	NN
sawala	NN
sawi	NN
sawit	NN
saya	NN
sayak	NN
sayang	NN
sayembara	NN
sayet	RB
sayidi	VB
sayu	NN
sayup	NN
sayur	NN
seba	PRP
sebab	NN
sebal	NN
sebam	NN
sebar	NN
sebasah	NN
sebat	NN
sebeng	NN
seberang	NN
sebet	NN
sebuk	NN
seburut	RB
sebut	NN
secerek	NN
secina	NNS
sedahan	NN
sedak	NN
sedam	CD
sedan	IN
sedang	NN
sedap	JJ
sedat	NN
sedatif	NN
sedekah	NNS
sedekap	JJ
sedeng	NN
sederhana	NN
sederum	NN
sedia	JJ
sediakala	IN
sedih	NN
sedikit	DT
sedimen	NN
sedimentasi	NN
sedimenter	NNS
sedingin	NN
sedot	NN
sedu	NN
seduh	VBN
sefalopoda	NNS
sefalotoraks	NN
seg	PRP
segak	NN
segala	DT
segan	VBN
seganda	NN
segar	JJ
segara	RB
segata	NN
segenap	JJ
segera	RB
segi	NNS
segianya	NN
segitiga	NN
segmen	NN
segmentasi	NN
segregasi	NN
sehat	JJ
sehingga	RB
sein	VB
seismik	JJ
seismograf	NN
seismolog	RB
seismologi	NN
sejahtera	JJ
sejak	IN
sejarah	NN
sejarawan	NN
sejari	DT
sejat	NN
sejati	JJ
sejingkat	DT
sejuk	NN
sek	NN
seka	DT
sekadar	RB
sekakar	JJ
sekakmat	NN
sekal	RB
sekala	RB
sekaligus	IN
sekalipun	IN
sekalor	NN
sekam	NN
sekan	JJ
sekang	IN
sekap	IN
sekapar	NN
sekarang	RB
sekarat	VBG
sekaut	NN
sekeber	NN
sekebun	NN
sekedeng	VBN
sekedup	RB
sekelian	NN
sekema	NN
sekendi	RB
sekengkeng	JJ
sekepat	IN
sekeram	DT
sekeri	NN
sekerindangan	DT
sekering	NN
sekh	NN
sekilwak	NNS
sekira	RB
seko	VBZ
sekoci	NN
sekolah	NN
sekon	JJ
sekongkol	NN
sekop	NN
sekopong	NNS
sekresi	NNS
sekreta	NN
sekretariat	NN
sekretaris	NN
sekretin	NN
sekring	NN
sekrup	NN
seks	NN
seksi	NN
seksmaniak	NN
seksolog	NN
seksologi	NN
seksologis	NN
sekstan	NN
sekstet	NN
seksual	JJ
seksualitas	NN
sektarian	JJ
sektarianisme	NN
sekte	NN
sektor	NN
sektoral	JJ
sekuas	NN
sekul	NN
sekularis	NN
sekularisasi	NN
sekularisme	NN
sekularitas	NNS
sekuler	NN
sekunder	NNS
sekunyit	NN
sekuritas	NNS
sekuriti	NN
sekutu	RB
sel	NN
selabar	RB
selaberak	NNS
selada	VBN
selai	NN
selain	IN
selaju	NN
selak	NN
selaka	NN
selalu	RB
selam	NN
selamat	NNS
selampai	NN
selampit	NN
selancang	NN
selancar	VBG
selang	NN
selangat	VBN
selangka	NN
selangkup	DT
selap	JJ
selapan	NN
selaput	NN
selar	NN
selara	NN
selaras	IN
selasa	NN
selasar	NN
selasih	NN
selat	NN
selatan	NN
selawah	NN
selawat	JJ
selaya	NN
sele	NN
selebaran	NNS
selebran	NN
selebrasi	NN
selebritas	NN
selebriti	NNS
selebu	NNS
seleder	NN
selederi	DT
seledri	NN
selekoh	NNS
selekor	DT
seleksi	NN
selektif	NN
selektivitas	NN
selempada	NN
selempang	VBG
selempuri	NN
selendang	NN
selenggara	NN
selentik	VBG
selenting	NN
seleo	IN
selepat	IN
selepe	NN
selera	NN
selerang	NN
selesa	JJ
selesai	VBN
selesma	NN
seletuk	NN
selia	NNS
seliap	JJ
selibat	NN
selibu	RB
selibut	NN
selidik	NN
seligi	NN
selimut	NN
selindung	NN
selingar	VBG
selingkuh	VBG
selingkup	NN
selip	NN
selipar	NNS
selir	NN
selira	NN
selirak	NN
selirat	NN
selisih	NN
selisik	NN
selisip	NN
selo	NN
selofan	NN
selokan	NN
selom	NN
selompret	NN
selon	VBG
selongsong	NN
selonong	RB
selop	NNS
seloroh	NN
seluar	NNS
selubung	NN
seludang	NN
seludu	DT
seludup	NN
seluk	VBG
selukung	NN
seluler	NN
seluloid	NN
selulosa	NN
selulur	NN
selumar	NN
selumbat	VBN
selumu	NNS
seluncur	VBG
selundat	NN
selundup	VBN
selup	DT
selupan	VBN
selupat	NN
selurah	NN
seluru	DT
seluruh	JJ
selusuh	NN
selusup	VBG
selusur	NN
selut	NN
sema	NN
semafor	NN
semaja	NN
semak	NN
semalu	DT
semampai	NN
semampang	NN
semampat	VBN
semangat	NN
semanggi	NN
semangka	NN
semangkok	DT
semantik	NNS
semantis	RB
semaput	JJ
semaya	NN
semayam	NN
semayi	NN
sembabat	NN
sembada	VBN
sembagi	IN
sembah	NN
sembahyang	NN
sembak	NN
sembam	NN
sembap	NN
sembar	NN
sembarang	DT
sembari	IN
sembayan	NN
sembelih	NN
sembelit	NN
semberap	VBG
semberip	NN
sembesi	NNS
sembeta	NN
sembilan	CD
sembilang	NN
sembilik	NNS
sembilu	NN
sembir	NN
semboyan	NN
sembrono	NN
sembuang	VBG
sembuh	VBN
sembul	NN
sembunyi	NN
sembur	NN
semburat	NN
semburit	NN
semecah	NN
semenanjung	NN
semendarasa	NN
semenjak	IN
sementara	IN
sementasi	NN
sementung	NN
semerbak	NN
semesta	NN
semifinalis	NNS
semiidiom	NN
semikonduktor	NN
seminari	NNS
seminaris	NNS
semiologi	NNS
semiotik	JJ
semiotika	NNS
semipermanen	NN
semitisme	NN
semok	NNS
sempadan	NN
sempak	NN
sempang	NN
sempat	VBD
sempena	IN
sempit	NN
sempoyong	NN
semprit	NN
semprot	NN
sempurna	NN
semrawut	JJ
semu	JJ
semua	DT
semunian	NN
semur	VBG
semut	NN
sen	PRP$
senak	NN
senam	NNS
senandung	VBG
senang	JJ
senangin	NN
senantan	NN
senantiasa	RB
senapan	NN
senapati	DT
senar	NN
senarai	NN
senario	NN
senat	NN
senawan	NN
senawat	NN
senawi	NNS
senda	NN
sendal	NNS
sendalu	RB
sendar	VBN
sendat	NN
sendawa	NN
sendayang	NN
sendel	NN
sendeng	VBN
senderik	NN
senderut	NNS
sendi	NN
sendiri	JJ
sendok	NN
sendon	NN
sendratari	NN
sendu	NN
senduk	NN
sengaja	RB
sengal	NN
sengap	NN
sengar	NN
sengarat	NN
sengaring	VBG
sengat	VBG
sengau	NN
senget	VBN
senggak	NN
senggang	JJ
senggau	NN
senggeruk	NN
senggugut	NN
senggut	NN
sengih	NN
sengit	NN
sengkak	NN
sengkal	NN
sengkalan	VBN
sengkang	NN
sengkar	NNS
sengkarut	NN
sengkayan	NN
sengkela	NN
sengkelat	NN
sengkeling	VBG
sengkelit	NN
sengketa	NN
sengkil	RB
sengkuap	DT
sengsai	NN
sengsara	JJ
sengsurit	NN
senguk	JJ
sengut	NN
seni	PRP
senil	NN
seniman	NN
senin	NN
senioritas	NN
seniwati	NN
senja	NN
senjang	NNS
senjata	NNS
senjolong	IN
senohong	NN
senonoh	NN
sensasi	NN
sensasional	JJ
sensibel	JJ
sensibilitas	NN
sensitif	JJ
sensitivitas	NN
sensoris	NN
sensualitas	NN
sensur	NN
sensus	NN
senta	NNS
sentada	VBG
sentadu	NN
sentak	NN
sentap	NN
senteng	NN
senter	NN
senti	NN
sentimen	NN
sentimentalitas	NN
sentimentil	NN
sentimeter	NNS
sentol	NN
sentong	NN
sentral	JJ
sentralisasi	NN
sentrifugal	NN
sentrum	NN
sentuh	NN
sentuk	NN
senu	JJ
senuk	NN
senunggang	NN
senur	NNS
senyap	JJ
senyar	NN
senyum	NN
sepada	NN
sepak	NN
sepakat	VBD
sepan	VB
separasi	NN
separatis	NN
separatisme	NN
separbang	NN
sepatu	NNS
sepeda	NN
sepedas	PRP
sepekuk	NN
sepele	JJ
sepen	NN
seperah	NN
seperti	IN
sepet	NN
sepetir	NNS
sepi	JJ
sepir	NN
sepoi	NN
seprai	NNS
seprei	NN
sepuh	RB
sepuit	NN
sepuk	NN
sepul	NN
sepur	NNS
sera	MD
serabi	NN
serabut	NNS
serabutan	NNS
serah	NN
terima	NN
serahi	NN
serai	MD
serak	NN
serakah	NN
seram	NN
serambi	NN
serampu	NN
serampuk	NN
seran	PRP
serana	NN
seranah	NN
serandang	NN
serandung	NN
serang	NN
serangga	NN
seranggung	NN
serangkak	NN
serangsang	NN
seranta	NN
serap	NN
serapah	NN
serapat	RB
serasah	NN
serasi	RB
serat	NN
serati	NNS
seratung	NN
serawal	IN
seraya	IN
serba	NN
serbaakal	NN
serbabaru	DT
serbabisa	NN
serbaemas	JJ
serbaguna	NN
serbak	NN
serbakurang	NN
serbaneka	NN
serbasama	DT
serbat	VBN
serbet	NNS
serbi	NN
serbu	NN
serbuk	NN
serdadu	NN
serdi	JJ
serealia	NNS
serebral	JJ
serebrum	NN
sereh	NN
seremoni	NN
seremonial	NN
serempet	NN
serendah	IN
serendeng	NN
serenjang	NN
seret	NN
sergah	VBD
sergam	IN
sergut	NN
seri	NN
seriap	DT
seriat	NN
seriawan	NN
seribulan	NN
serigala	NN
serikat	NN
serikaya	DT
serindai	NN
sering	RB
seringai	NN
seringing	RB
seriosa	JJ
serit	NN
serium	RB
serius	JJ
serkah	NN
serkai	NNS
sermet	NN
seroja	NN
serologi	NN
serombong	NN
serompok	NN
serondong	NN
serong	NN
seronok	NN
serpentina	NN
serpih	NNS
sersan	NN
sersi	NN
sertifikasi	NN
sertifikat	NN
seru	VBG
seruduk	VBN
seruh	VB
seruit	VBN
seruk	NN
serul	NN
seruling	NN
serumpu	NN
serundang	NNS
serunjang	NN
seruput	NNS
serut	NN
seruyuk	NN
servis	NN
sesah	JJ
sesak	VBN
sesal	NN
sesam	NN
sesanti	NN
sesar	NN
sesat	VBN
sesenap	DT
sesi	NN
sesira	NN
sespan	NN
seta	NN
setabelan	VBG
setai	NNS
setan	NN
setang	NN
setangan	NN
setanggi	JJ
setat	NN
setawar	NN
setek	NNS
setel	NN
setela	IN
setem	NN
setempel	NN
seten	NNS
seter	NNS
seteru	NNS
seti	NN
setia	NN
setiabu	NN
setiawan	NN
setiga	DT
setik	NN
setin	NN
setinggi	IN
setir	VBG
setoka	NN
setor	NN
setrika	NN
setrip	NN
setrum	NN
setti	NN
setum	NN
setung	NN
seturi	NNS
seudati	NN
sewa	NN
sewah	NN
sewaka	NN
sfigmograf	NN
sfingofili	NNS
sfingter	NN
sfinks	NN
si	CC
sia	DT
siaga	NN
siakap	NN
sial	NN
sialang	NN
siang	NN
sianida	NN
sianosis	NN
siap	JJ
siapa	WP
siapuh	JJ
siar	NN
siarah	NN
siat	NNS
sibak	NN
sibernetika	NN
sibilan	NN
sibuk	JJ
sice	IN
sida	NN
sidai	NN
sidang	NN
sidat	NN
siderit	NN
sidik	NN
siduga	IN
siduk	NNS
sif	NN
sifat	NN
sifer	NN
sifilis	NN
sifon	NN
sigai	NN
sigak	NN
sigando	NN
sigap	NN
sigar	NN
sigaret	NN
siger	VB
signifikan	JJ
signifikansi	NN
signifikasi	NN
sih	RB
sihir	NN
sijil	NN
sikai	NN
sikap	NN
sikas	NN
sikat	NN
sikedempung	NNS
sikik	NN
sikin	NN
sikit	DT
siklis	NN
sikloid	NN
siklon	NN
sikloparafin	DT
siklus	NN
siksa	NN
siku	NN
sikudidi	RB
sikudomba	NN
sikut	NN
sil	NNS
sila	NN
silabis	NN
silabus	NN
silah	NN
silalatu	NN
silam	RB
silang	NN
silap	JJ
silase	NN
silaturahmi	NN
silau	VBN
silet	NN
silik	JJ
silika	NN
silikat	NN
silikon	NN
silikona	NN
silinder	NN
silindris	JJ
silir	NN
silium	NN
silogisme	NN
silok	NN
siloptik	JJ
silsilah	NN
siluet	NN
siluman	NN
silvikultur	NN
simak	VB
simaung	NN
simbai	JJ
simbion	NN
simbiosis	NN
simbok	DT
simbol	NN
simbolis	NN
simbolisme	NN
simetri	NN
simetris	JJ
simfoni	NN
simile	JJ
simpai	NN
simpan	VB
simpang	NN
siur	VBN
simpanse	NNS
simpati	NN
simpatik	JJ
simpatisan	NN
simpel	NN
simping	NN
simpleks	NN
simposium	NN
simpuh	NN
simpuk	NNS
simpul	NN
simpur	NN
simtom	NN
simulasi	NN
simulfiks	NN
simultan	JJ
simuntu	RB
sin	IN
sinagoge	NN
sinambung	JJ
sinar	NNS
sinau	NN
sindap	NN
sindikasi	NN
sindikat	NN
sindir	JJ
sindrom	NN
sindur	VBG
sineas	NN
sinektika	NNS
sinema	NN
sinematik	JJ
sinematograf	NN
sinematografi	NN
sinergi	NN
sinergis	JJ
sinestesia	NN
singa	NN
singelar	JJ
singgah	NN
singgan	VBN
singgasana	NN
singgit	NN
singgul	NN
singgung	NN
singkak	NN
singkang	NN
singkap	JJ
singkat	JJ
singkek	NN
singkir	VB
singkong	NN
singkur	NN
singsat	NN
singsing	NN
singularis	JJ
singulum	NN
sinis	JJ
sinisme	NN
sinkope	NN
sinkretis	NN
sinkretisasi	NN
sinkretisme	NN
sinkron	NN
sinkronis	JJ
sinkronisasi	NN
sinkronisme	NN
sinode	NN
sinologi	NNS
sinom	NN
sinoman	NN
sinonim	JJ
sinonimi	NN
sinopsis	NN
sinoptis	JJ
sinovia	NN
sinovitis	NN
sinrili	NN
sintagma	NN
sintal	NN
sintas	NN
sinterklas	NN
sintese	NN
sintesis	NN
sintetik	JJ
sintetis	JJ
sintua	NN
sintuk	NN
sinu	NNS
sinusal	NN
sinyal	NN
sinyalemen	NN
sinyalir	NN
sioca	NN
sipangkalan	NN
sipat	NNS
sipedas	NN
sipi	NN
sipil	JJ
sipir	NN
sipit	NN
siput	NN
sira	JJ
sirah	NN
siram	NN
sirap	NN
siraut	NN
sirene	NNS
siriasis	NNS
sirib	NN
sirik	JJ
sirip	NN
sirkam	NN
sirke	NN
sirkuit	NN
sirkulasi	NN
sirkuler	NN
sirkus	NN
sirlak	NNS
sirop	NN
sirsak	NN
siru	NN
sisa	DT
sisi	NN
sisih	NN
sisik	NN
sisip	NN
sisir	NN
sistem	NN
sistematik	JJ
sistematika	JJ
sistematis	JJ
sistematisasi	NN
sistemis	PRP
sistemisasi	DT
sistitis	NN
sistole	NN
sistolik	NN
siswa	NNS
siswi	NN
sitat	NN
siti	NNS
sitir	NN
sitolisis	NN
sitologi	NN
sitoplasma	NN
sitrat	NN
sitrin	NN
sitrun	NN
situasi	NN
situasional	JJ
situn	NN
situs	NN
siuh	VBN
siuman	PRP
siung	NN
sizigi	NNS
skafa	NN
skala	NN
skalar	NN
skandal	NN
skandium	NN
skarifikasi	NNS
skatola	NN
skatologi	NN
skedul	NNS
skelet	NN
skema	NN
skematis	JJ
skenario	NN
skeptis	JJ
skeptisisme	NN
sketsa	NN
skiameter	NN
skisma	NN
skizofrenia	NN
sklerenkima	NN
skleroterapi	NN
skolastik	JJ
skolastikus	NNS
skolastisi	NNS
skolastisisme	PRP$
skop	NN
skor	NNS
skors	NN
skrin	NN
skrip	NNS
skripsi	NN
skrotum	NN
skuadron	NN
skuter	NN
slagorde	NN
slebor	JJ
slof	NN
snobisme	NN
soal	NN
soba	NN
soban	NN
sobat	NN
sodok	NN
sodomi	NN
sodomia	NN
sodor	NN
soe	NN
soga	NN
sogan	NN
sogok	NN
sohib	NN
sohor	JJ
soja	NN
sok	JJ
soker	NN
soket	NN
sokom	NN
sokong	NN
solak	JJ
solang	IN
solanina	NN
solek	NN
solenoide	NN
solidaritas	NN
soliditas	NN
soliter	JJ
solois	NN
solokan	NN
solot	NN
solum	RB
solusi	NNS
solvabilitas	NN
solven	NN
som	IN
somah	NN
sombong	JJ
sombrero	NN
someng	NN
somnambulisme	VBG
sondase	NN
sonder	IN
soneta	NN
songgeng	NN
sono	NN
sontak	NN
sontok	NN
sontoloyo	NN
sopak	NN
sopan	NN
sopi	NN
sopir	NN
sopran	NN
sorak	NNS
sorang	RB
sorgum	NNS
sori	NN
sorok	NNS
sorong	NN
sorot	NN
sortir	NN
sosi	JJ
sosial	JJ
sosialis	NN
sosialisasi	NN
sosialisme	NN
sosiawan	NN
sosiobiolog	NN
sosiodemokrasi	NN
sosiokultural	JJ
sosiolek	NN
sosiolinguistik	JJ
sosiolog	NN
sosiologi	NN
sosiologis	JJ
sosiometri	NNS
sosis	NN
sosok	NN
sotong	NN
soyak	NN
spageti	NNS
spanduk	NN
spaning	NN
spasi	NN
spasial	JJ
spasmus	NN
spastik	JJ
spatbor	NN
spektakel	NN
spektakuler	NN
spektator	NN
spektograf	NN
spektogram	NN
spektrograf	NN
spektrometer	NN
spektrum	NN
spekulan	NNS
spekulasi	NN
spekulatif	JJ
spekulator	NNS
speleologi	NNS
sperma	NN
spesial	JJ
spesialis	NN
spesialisasi	NN
spesies	NNS
spesifik	JJ
spesifikasi	NN
spesimen	NNS
spidol	NN
spidometer	NN
spil	NN
spion	NN
spionase	NN
spirilum	NN
spiritisme	NN
spiritualisme	NN
spiritus	NN
spons	NNS
spontan	JJ
spontanitas	NN
spora	NN
sporadis	NN
sporofil	NN
sportif	JJ
sportivitas	NN
sreg	JJ
srikandi	NN
srimanganti	JJ
stabil	JJ
stabilisasi	NN
stabilisator	NN
stabilitas	NN
stadion	NN
staf	NN
stagnan	NN
stagnasi	NN
stalagmit	NN
stalaktit	NNS
stalinisme	NN
stamba	NN
standar	NN
standardisasi	NN
stanum	NN
stasioner	JJ
stasiun	NN
statis	JJ
statistik	NNS
statistika	NNS
statuta	NNS
stearat	NN
steik	NN
stek	NN
steker	NNS
stema	NN
stemma	NNS
stempel	NN
sten	NN
stengun	NNS
steno	NN
stenografi	NN
stenogram	NNS
stensil	NN
stepa	NN
stereotip	NNS
steril	NN
sterilisasi	NN
sterilitas	NN
stetoskop	NN
stik	NN
stiker	JJ
stilir	NN
stilistika	NNS
stimulan	NNS
stimulasi	NN
stipendium	NN
stirena	NN
stoikiometri	NN
stok	NN
stokastik	RB
stoper	NN
stopkontak	JJ
stoples	NNS
stori	NN
strategi	NN
strategis	JJ
stratifikasi	NN
stratigrafi	NN
strato	NN
stratosfer	DT
streng	NN
streptokokus	NN
stres	NN
striptis	NN
stroberi	NN
stromking	JJ
struktur	NN
struktural	JJ
strukturalisasi	NN
strukturalisme	NN
studen	NNS
studi	VB
stuko	NN
sua	PRP$
suaka	NN
suam	PRP$
suami	NN
suaminda	PRP$
suap	NN
suar	TO
suara	NN
suarawati	NN
suasana	RB
suat	NN
suatu	NN
subam	VB
suban	VB
subbab	NN
subbagian	NNS
subdirektorat	NN
subentri	VB
subetnik	NN
subjek	NN
subjektif	NN
subkategorisasi	NN
subkelas	NN
subkontraktor	NN
subkultur	NN
sublema	NN
sublim	NN
sublimasi	NN
submukosa	NN
subordinasi	NN
subordinat	NN
suborganisasi	NN
subsider	NN
subsidi	NN
substansi	NN
substansial	JJ
substantif	JJ
substitusi	NN
substitutif	NN
substrat	NN
subtil	NN
subtropik	JJ
subuh	NN
subur	NN
subversi	NN
subversif	NN
subyek	NN
subyektif	NN
subyektivisme	NN
suceng	NN
suci	NN
sudah	RB
sudet	NNS
sudu	NN
sudut	NN
sufiks	NN
sufisme	NN
sugesti	NN
sugih	JJ
suguh	TO
suhad	NN
suhu	NN
sujen	NNS
sujud	NN
suka	IN
sukacita	NN
sukan	NNS
sukar	JJ
sukarela	JJ
sukarelawan	NNS
sukaria	NN
sukat	NNS
suke	PRP
suket	NN
sukma	NN
sukrosa	NN
sukses	NN
suksesi	NN
suksesif	NN
suku	NN
sukuisme	NN
sukun	NN
sulalah	NN
sulap	NN
sulfat	NN
sulfonamida	NN
suli	NN
sulih	NN
suling	VBN
sultanat	NN
suluh	NN
sulung	RB
sulur	NNS
sumbangsih	NN
sumbar	NN
sumbat	NN
sumber	NN
sumbing	JJ
sumbu	NN
sumbuk	NN
sumbut	VBN
sumilir	NN
sumir	DT
sumirat	NN
sumpah	NN
sumpek	NN
sumping	JJ
sumpit	NNS
sumsum	NN
sumur	RB
sunam	VBG
sunan	NN
sunat	NN
sundal	VBD
sundang	NN
sunduk	PRP
sundusin	PRP
sundut	NN
sunggit	NN
sungguh	RB
sungguhpun	RB
sungil	NN
sungkal	NN
sungkan	NN
sungkawa	NN
sungkuk	VBG
sungkum	NN
sungkup	NN
sungkur	NN
sungkuran	NN
sungsang	NN
sungu	NN
sungut	NN
suni	JJ
sunjam	NN
suntiabu	NN
suntih	NN
suntik	NN
sunting	NN
suntuk	DT
sunu	NN
sunyi	JJ
supa	NN
supaya	RB
supel	VBG
superblok	NN
supercepat	NN
superfisial	JJ
superfosfat	NN
superioritas	NN
superkomputer	NN
superkonduktivitas	NN
superkonduktor	NNS
superlatif	NN
superlativisme	NN
supersonik	JJ
supervisi	NN
suplai	NN
suplemen	NN
suplementasi	NN
suporter	NNS
suportif	NN
suprarene	JJ
suprasasti	RB
supremasi	NN
supresif	NN
supresor	NN
sura	NN
suram	NN
surat	NN
surati	NN
surealis	NN
surfaktan	NN
surga	NN
surgawi	RB
surih	NN
surogat	NN
suruh	NN
suruk	JJ
surup	NN
surut	VBG
survei	NN
sus	PRP$
susah	JJ
susilat	VB
suspender	NN
suspensi	NN
suster	NN
susu	NN
susuh	NN
susuk	NN
susul	NN
susun	VBG
susung	NN
susup	NN
susut	RB
sut	WRB
sutil	NN
sutradara	NN
sutura	NN
suul	NN
suun	JJ
suvenir	NN
suwita	NN
swabela	NN
swadana	NN
swadaya	NN
swadidik	NN
swak	JJ
swakaji	NN
swakelola	NN
swakontradiksi	NN
swalayan	NN
swanama	MD
swasembada	NN
swasta	JJ
swastanisasi	NN
swatabur	VBG
swausaha	PRP
sweter	NN
swimpak	NN
syabah	NN
syabas	NN
syafaat	NN
syah	JJ
syahadat	NN
syahid	NN
syahriah	NN
syahwat	NN
syair	NN
syak	NN
syakban	NN
syal	NN
syala	NN
syam	NN
syamali	NN
syaman	NN
syarat	NN
syarif	NN
syarikat	NN
syeir	NN
syekh	NN
syeti	NN
syikak	NN
syin	NNS
syirik	NN
syiwa	NN
syok	NN
syuhada	NN
syukur	NN
syumuliah	JJ
syur	VBG
syuriah	NN
syuruk	JJR
taasub	NN
taat	NN
tabak	NN
taban	NN
tabe	VB
tabel	NN
tabela	NN
tabernakel	NN
tabia	NN
tabiat	NN
tabib	NN
tabii	IN
tabik	NN
tabir	NN
tablo	NN
tabo	PRP
tabok	NN
tabrak	NN
tabuh	NN
tabula	NN
tabulasi	NN
tabulatur	NN
tabung	NN
tabur	NN
tabut	NN
taci	NN
tadah	VBN
tadaruk	DT
tadbir	NN
tadi	RB
tadir	NN
taf	VB
tafeta	NN
tagal	NN
tagih	NN
tago	NN
tah	NN
tahak	IN
tahan	NN
tahana	NNS
tahang	NN
tahap	NN
tahbis	NN
tahi	CD
tahiat	NN
tahkik	NN
tahkim	NN
tahlil	NN
tahniah	NNS
tahsil	VBN
tahun	NN
taifun	NN
taiko	NNS
taipan	NN
tais	JJ
taiso	VBN
taja	NN
tajak	NN
tajali	NN
tajam	JJ
tajarud	NN
tajen	NN
tajin	NN
tajnis	PRP
tajuk	NN
tak	RB
takabur	JJ
takal	DT
takar	NN
takat	NNS
takdir	NN
takhayul	NN
takhta	NN
taki	JJ
takik	NN
takjub	VBN
taklif	NN
taklim	NN
taklimat	NN
takluk	VBN
takma	JJ
takmurni	NN
takrif	NN
takrir	NN
taksa	NNS
taksasi	NN
taksem	NN
taksi	RB
taksimeter	NN
taksir	NN
taksologi	NN
taksonomi	NN
taktik	NNS
taktil	NN
taktis	JJ
takuk	NN
takut	NN
takwa	NN
takwim	NN
takziah	NNS
tal	IN
tala	NN
talabiah	NN
talak	NN
talam	NN
talang	NN
talar	NNS
talas	NN
talen	NNS
talenan	VBG
talenta	NNS
tali	DT
talium	JJ
talu	DT
tamadun	NN
tamak	NN
tamam	NN
taman	NN
tamasya	VBG
tamat	NN
tambah	VBD
tambak	NNS
tambakan	NN
tambal	NN
tambang	NN
tambat	VBG
tambi	NN
tamborin	NN
tambuh	NN
tambul	NN
tambun	NN
tambung	NN
tambur	NN
tameng	NN
tamimah	VBD
tampak	NNS
tampal	NN
tampan	NN
tampang	NNS
tampar	NN
tampas	NNS
tampi	NN
tampik	VB
tampil	VB
tampuk	NN
tampung	NN
tamsil	NN
tamtama	VBN
tamu	NN
tamuk	NN
tanang	DT
tanazul	NN
tancang	NN
tancap	NN
tanda	NN
tandan	NNS
tandang	RB
tandas	NN
tandu	RB
tanduk	NN
tandun	NN
tandus	NNS
tangap	NN
tangar	NN
tangas	NNS
tangen	NN
tanggah	NN
tanggal	NN
tanggam	NN
tanggap	NN
tanggar	NNS
tanggetong	NN
tangguh	JJ
tangguk	NN
tanggul	NN
tanggulang	NN
tanggung	NN
tangis	NNS
tangkah	WRB
tangkai	NN
tangkaian	NN
tangkal	NNS
tangkap	NN
tangkar	NN
tangkas	NN
tangki	NN
tangkil	NN
tangkuk	DT
tangkul	NN
tangkup	NN
telentang	IN
tangkur	NNS
tanglung	NN
tangsa	NN
tani	RB
tanji	NN
tanju	NN
tanjung	NN
tanjur	NN
tanpa	IN
tantang	NN
tante	NN
tanti	JJ
tantiem	NNS
tantrisme	NN
tanur	NN
tanwujud	NN
taocang	NN
taoci	NN
taoge	NN
taoisme	NN
taoke	NN
taosi	NN
tapa	NN
tapai	NN
tapak	NN
tilas	NN
tapal	NN
tapang	NN
tapestri	NN
tapi	CC
tapioka	NN
tapis	NN
taplak	NN
taptu	TO
tapus	IN
tara	DT
taraf	NN
tarak	NN
taram	NN
taraqi	NN
tarbiah	NN
tarhim	NN
tari	NNS
tarif	NN
tarik	NN
tarikh	NN
tarkas	NN
tarmak	NN
tartir	NN
tartrat	NN
taruh	NN
taruk	NN
tarum	NN
tarung	NN
tarup	NN
tas	DT
tasa	NN
tasai	IN
tasak	NN
tasawuf	NN
tasbih	NNS
tasdik	NN
tasel	DT
tashih	NN
tasik	NN
tasyakur	NN
usaha	NN
tataganing	TO
tatai	NNS
tatak	NN
tatal	NN
tatanan	NN
tatap	NN
tatih	NN
tatkala	WRB
tato	DT
tau	PRP$
taufik	NN
taul	NN
taur	NN
taurat	DT
tautofoni	NN
tautonimi	NN
tawa	NN
tawajuh	DT
tawarik	NN
tawon	NN
tayang	VBG
tean	VB
teater	NN
teatris	IN
tebah	NN
tebak	NN
tebang	VBG
tebar	VBG
tebat	NNS
teberau	JJ
tebing	NN
tebu	NN
tebuk	NN
tebus	VBN
tedas	VBG
tedeng	NN
teduh	NN
tedung	NN
tega	DT
tegah	JJ
tegak	NN
tegang	NN
tegap	VBG
tegar	JJ
tegari	NN
tegas	JJ
tegmen	VBG
teguh	NN
teguk	NN
tegun	VBG
tegur	NN
teisme	IN
teja	NN
teji	NN
teki	VBD
tekaan	NN
tekad	NN
tekah	NN
tekak	NN
tekalak	NN
tekan	NN
tekang	NNS
tekar	NN
tekat	NN
tekel	NN
teken	NN
teker	NN
tekik	JJ
tekis	DT
teklek	NNS
teklok	NN
teknifon	NN
teknik	JJ
teknikus	NN
teknis	JJ
teknisi	JJ
teknokrasi	NN
teknokrat	NNS
teknokratik	JJ
teknokratisme	NN
teknologi	NN
teko	PRP
tekoan	IN
tekoh	DT
tekor	VB
teks	NN
tekstil	NN
tekstur	NN
tekte	VBG
tektek	NN
tektogenesa	NN
tektonik	NNS
tektonis	NN
tekuk	NN
tekun	NN
tekung	NN
tekur	VBZ
tela	NN
telaah	NN
telacak	NN
teladan	NN
telaga	NN
telah	VBZ
telak	NN
telan	NN
telancang	NN
telang	NN
telanjang	JJ
telanjur	RB
telantar	VBN
telap	JJ
telapak	NNS
telas	NNS
telat	RB
telatah	NN
telaten	VBG
telau	NN
teledor	NN
telefon	NN
telefoni	NNS
telefoto	NN
telegraf	NN
telegrafi	NN
telekap	NN
telekomedi	NN
telekomunikasi	NN
telemetri	NNS
telempap	NN
teleng	NN
telenovela	NN
telepati	NN
telepon	NN
telepuk	NN
teler	NN
teleskop	NN
telestesia	NN
televisi	NN
telgram	NN
telik	VB
telimpuh	NN
telinga	NN
telingkah	NN
teliti	JJ
telor	NNS
telpon	NN
teluh	NN
teluk	NN
teluki	NN
telungkup	NN
telunjuk	NN
telur	NN
telurit	NN
telusuk	NN
telusur	NN
telut	VBG
tem	VBZ
tema	NN
teman	NN
temanten	NNS
temaram	NN
temas	NNS
tematik	JJ
temayun	NN
tembaga	NN
tembak	NN
tembakang	NN
tembakau	NN
tembakul	NN
tembam	NN
tembang	NN
tembatar	JJ
tembatu	DT
tembek	VBN
tembel	NN
tembelang	NNS
tembelian	NN
tembeliung	NN
temberam	NN
temberek	NN
tembereng	NN
temberih	NN
tembiang	NN
tembikai	NN
tembikar	NN
tembilang	NN
tembilar	NN
tembok	NN
tembolok	NN
tembong	NN
tembosa	NN
tembu	NN
tembuk	NN
tembuku	PRP$
tembung	NN
tembus	NN
temeh	PRP
temetu	NN
temin	NN
temoleh	VB
tempa	DT
tempan	NN
tempang	NN
tempap	RB
tempat	DT
tempaus	NN
tempawak	RB
tempawan	NN
tempayak	NN
tempayan	NNS
tempayung	RB
tempek	NN
tempel	NN
tempelak	RB
tempeleng	NN
temperamen	NN
temperatur	NN
tempiar	RB
tempik	NN
tempilai	NN
templok	NN
tempo	NN
tempoh	NN
temporer	JJ
tempoyan	NN
tempua	RB
tempuh	NN
tempuling	NN
tempunik	NN
tempur	NN
tempurung	NN
tempus	NN
temu	RB
temurat	NN
tenaga	NN
tenang	JJ
tenar	NN
tenat	JJ
tenda	NN
tendang	NN
tendas	NNS
tendensi	NN
tendensius	JJ
tendo	IN
tener	TO
tengadah	NN
tengah	NN
tengalan	NN
tengar	NN
tengara	NN
tengas	VB
tenggak	DT
tenggala	NN
tenggang	NN
tenggara	NN
tenggat	NN
tenggayun	NN
tenggayung	VBG
tenggek	NN
tenggelam	VBG
tenggiling	NN
tenggiri	NN
tenggorok	NN
tengik	NN
tengil	NN
tengkalak	NN
tengkalang	NN
tengkaluk	NN
tengkam	NN
tengkang	NN
tengkar	NN
tengkarah	NN
tengkarap	NN
tengkaras	NNS
tengkawang	NN
tengking	NN
tengkorak	NN
tengkuk	DT
tengkulak	NN
tengkurap	NN
tengok	NN
tengteng	NN
tenis	NN
tenjet	NN
tenok	NN
tenong	NN
tensi	NN
tentakel	NN
tentamen	NN
tentang	IN
tentara	NN
tentatif	NN
tenteram	NN
tentir	NN
tentu	JJ
tenuk	NNS
tenun	VBG
tenung	NN
teokrasi	NN
teokratis	JJ
teolog	JJ
teologi	NN
teologis	JJ
teoretikus	JJ
teoretis	JJ
teori	NN
teorisasi	DT
teosofi	NN
teosofis	NN
tepa	RB
salira	PRP
tepak	NN
tepam	NN
tepas	NN
tepat	NN
tepek	JJ
tepi	NN
tepok	NN
teptibau	NN
tepuk	NN
tepung	NN
tawar	NN
ter	NN
teracak	VBN
terak	VB
terakota	NN
terakup	VBN
teramisin	VB
terampil	VBN
terang	VB
terapeutik	JJ
terapi	NN
teras	NN
terasi	VB
teraso	NN
teratai	NN
teratak	VB
teratap	VBN
teratu	VB
terau	VB
terawang	NN
terban	IN
terbang	NN
terbis	VB
terbit	VBN
terbul	VBN
terem	VB
terendak	NN
terenen	VB
terenyuh	VBN
teres	VB
teret	VB
teretet	VB
teriak	NN
terigu	VB
terik	VBG
terikit	NN
teripang	NN
teritip	VB
teritorial	NN
teritorium	VB
terjal	NN
terjang	NN
terjemah	VB
terjun	NN
terka	NN
terkam	VB
terkap	VBN
terkul	RB
terkup	VB
terlak	NN
terlut	VBN
termal	VB
termin	VB
terminasi	VB
terminografi	VB
terminologi	NN
termistor	NN
termodinamika	NNS
termodinamis	NNS
termoelektris	NN
termoelektrisitas	VB
termofili	NN
termograf	NN
termogram	VB
termohigrograf	NN
termokimia	VB
termoklin	VB
termometer	NN
termonuklir	VB
termoplastik	JJ
termos	NNS
termosfer	NN
termostat	NN
terna	VB
ternak	NN
terobos	VB
teroka	VB
terombol	VBN
teromol	NN
terompah	VBN
terompet	NN
terong	NN
teropong	NNS
teror	NN
teroris	NN
terorisme	VB
terowongan	NN
terpal	NNS
terpana	VBN
terpentin	NN
tersier	VB
tertib	RB
terubuk	VBN
terucukan	PRP
teruk	RB
terumba	NNS
terumbu	NNS
terumbuk	VBN
terung	VB
terungku	PRP$
teruntum	VBN
terwelu	VB
terzina	VB
tes	PRP$
tesaurus	NN
tesis	NN
tesmak	TO
testa	NN
testamen	NN
testikel	NN
testimonium	NN
testosteron	NN
teta	NN
tetak	VBN
tetangga	NNS
tetap	NN
tetapi	CC
tetas	NNS
teteguk	NN
tetelo	NN
tetes	NNS
tetibar	NN
tetikus	NN
tetraklorida	NN
tewas	VBN
tezi	NNS
tiada	DT
tiaga	NN
tiam	RB
tian	JJ
tiang	NN
tiap	DT
tiarap	VB
tib	NN
tiba	VBN
tidak	DT
tidur	NN
tifus	NN
tiga	CD
tigari	NNS
tigas	NN
tik	RB
tika	VBD
tikai	RB
tikam	NN
tikar	NN
tikas	NN
tiket	NNS
tikus	NN
tilam	NN
tilan	DT
tilang	NN
tilik	NN
timah	NN
timbal	NN
timbang	NN
timbau	NN
timbel	NN
timbuk	NN
timbul	NN
timbun	NN
timburu	JJ
timbus	NN
timpa	NN
timpal	NNS
timpang	NN
timun	NN
timur	NN
timus	NN
tin	VB
tindak	VB
tindan	NN
tindas	NN
tindawan	NN
tindih	NN
tindik	VBG
tiner	NN
ting	NN
tinggal	NN
tinggam	JJ
tinggi	JJ
tinggung	NN
tingi	NN
tingkah	NN
tingkap	NNS
tingkas	VB
tingkat	NN
tingkeb	NN
tingtong	NN
tingtur	NN
tinjau	NN
tinju	NN
tinta	NN
tinulat	VBN
tipar	NN
tipe	NN
tipi	NNS
tipikal	JJ
tipis	NN
tipograf	NN
tipografi	NN
tipologi	NN
tipu	NN
tir	NN
tirai	NN
tiram	NN
tiran	NN
tirani	NN
tiras	NNS
tiris	VBD
tirkah	NN
tiroid	NN
tiroiditis	NN
tiru	NN
tirus	VBN
tis	NN
tisik	NN
tisu	NNS
titah	VBD
titel	NN
titik	NN
titimangsa	NN
titip	VBN
titis	NN
titrasi	NN
tiung	NN
tiup	JJ
toas	IN
tobak	NN
tobat	NN
toga	IN
togok	NN
tohok	NN
tok	VBD
toke	NN
tokek	NN
toko	NN
tokoh	NNS
tokok	NNS
toksemia	NN
toksikogenik	NN
toksikolog	NN
toksikologi	NN
toksin	NNS
toktok	NN
tol	NNS
toleh	NN
toleran	NN
toleransi	NN
tolok	NN
tolol	JJ
tolong	NN
toluena	NN
toman	PRP
tomat	NN
tombak	NN
tombol	NN
tombola	NN
tombong	NN
tombru	NN
ton	PRP$
tona	PRP$
tonase	NN
tonem	NN
tonetika	NN
tong	NN
tonggak	NN
tonggara	NN
tonggeret	NN
tonggok	NN
tonggos	NNS
tongkang	NN
tongkat	NN
tongkol	NN
tongkrong	VBG
tongong	NN
tongpes	NNS
tongsit	NN
tongtong	NN
tonik	NN
tonikum	NN
tonil	NN
tonit	NN
tonjok	NN
tonton	NN
topan	NN
topang	NN
topek	NN
topeng	NN
topes	NNS
topi	NN
topik	NN
topo	NN
topografi	NN
toponimi	NNS
toraks	NN
torek	NN
torida	NN
torium	NN
torne	NN
torsi	NN
tortor	NN
toserba	NN
totalisator	NN
totalitas	NN
totaliter	JJ
totau	DT
totok	JJ
tra	IN
tradisi	NN
tradisional	JJ
tradisionalisme	NN
trafo	NN
tragedi	NN
tragis	NN
trakeid	NNS
trakom	NN
traksi	NN
traktat	NN
traktir	NN
traktor	NN
traktus	NN
trama	NN
trampolin	NN
transaksi	NN
transek	NNS
transeksual	JJ
transenden	NN
transendental	NN
transfigurasi	NN
transformasi	NN
transformatif	NN
transformator	NN
transfusi	NN
transgenik	NN
transisi	NN
transitif	NN
transkrip	NN
transkripsi	NN
translasi	NN
transliterasi	NN
translokasi	NN
transmigran	NNS
transmigrasi	NN
transmisi	NN
transmiter	NN
transnasional	JJ
transparan	NN
transparansi	NN
transpirasi	NN
transplantasi	NN
transpor	NN
transportasi	NN
trapesium	NN
traumatis	JJ
travesti	NN
trayek	NN
trem	NN
trema	NNS
tremer	NN
tren	NN
trendi	NNS
trenyuh	NN
tres	CD
tresna	NN
politika	NN
triatlon	NN
tributa	NNS
tridarma	NN
trienial	NN
trigatra	NN
trigliserida	NNS
trigonometri	NN
trik	NNS
triko	NN
trikotomi	NN
trikuspid	NNS
triliun	CD
trilogi	NN
trinitas	NN
tripartit	NN
tripleks	NN
tripsin	NN
triptofan	NN
trisep	NNS
trisula	NN
tritunggal	NN
triumvirat	NN
triwangsa	NN
triwindu	NN
triwulan	NN
trofi	NN
trofoblas	NNS
troi	NN
trokea	NN
troli	NN
trombin	NN
trombon	NN
trombosis	NN
trombosit	NNS
trompet	NN
tropik	JJ
tropika	JJ
tropis	JJ
tropisme	NN
tropus	NN
tros	VBN
trotoar	NN
trubadur	NN
truf	NNS
truk	NN
truntum	NN
trusa	NN
tuah	JJ
tuai	NN
tuala	NN
tuam	PRP$
tuan	NN
tuang	NN
tuanku	PRP$
tuap	NN
tuar	VBN
tuas	PRP$
tubektomi	NN
tuberkulosis	NN
tubi	NNS
tubin	NN
tubir	NNS
tuduh	NN
tufa	NNS
tugar	JJ
tugi	NN
tugu	NN
tugur	NNS
tuhan	NN
tui	NN
tuidi	NN
tuit	NN
tujah	NN
tuji	JJ
tuju	DT
tujuh	CD
tujul	NN
tukak	NN
tukang	NN
tukar	NN
tukas	VBD
tukik	VBG
tukmis	NNS
tuksedo	NN
tuku	NN
tukuk	NN
tukul	NN
tukun	DT
tukung	NN
tukup	NN